name	ipa	phonetic
Aaron	ˈɛrən	a’-ur-un
Aaronites	ˈɛrən.aɪts	a’-ur-un-ites
Abaddon	əˈbædən	ab-ad’-dun
Abagtha	æb.æɡ.θɑ	ab-ag’-thah
Abana	æb.ˈeɪ.nɑ	ab-ay’-nah
Abarim	ˈæb.ə.rɪm	ab’-ar-im
Abba	ˈæbb.ɑh	ab’-bah
Abda	ˈæb.dɑ	ab’-dah
Abdeel	ˈæb.di.ɛl	ab’-de-el
Abdi	ˈæb.daɪ	ab’-di
Abdiel	ˈæb.di.ɛl	ab’-de-el
Abdon	ˈæb.dən	ab’-dun
Abednego	ˈæb.ɛdˌni.goʊ	ab-ed’-ne-go
Abel	ˈeɪ.bəl	a’-bel
Abel Keramim	ˈeɪ.bəlˈkɛr.əˌmɪm	a’-bel-ker-a’-mim
Abelbethmaachah	ˈeɪ.bəlˈbɛθˈmɑ.əˌkɑ	a’-bel-beth-ma’-a-kah
Abelmaim	ˈeɪ.bəlˈmaɪm	a’-bel-ma’-im
Abelmeholah	ˈeɪ.bəlˈmiˌhoʊ.lɑ	a’-bel-me-ho’-lah
Abelmizraim	ˈeɪ.bəlˈmɪzˌraɪm	a’-bel-miz’-ra-im
Abelshittim	ˈeɪ.bəlˈʃɪt.ɪm	a’-bel-shit-tim
Abez	ˈeɪ.bɛz	a’-bez
Abi	ˈeɪ.baɪ	a’-bi
Abia	ˈæb.iˌɑ	ab-i’-ah
Abiah	ˈæb.iˌɑ	ab-i’-ah
Abialbon	ˈæb.iˈæl.bʌn	ab’-i-al’-bun
Abiasaph	ˈæb.iˈæs.æf	ab-i’-as-af
Abiathar	ˈæb.iˌʌ.θɚ	ab-i’-uth-ur
Abib	ˈeɪ.bɪb	a’-bib
Abida	ˈæb.ɪ.dɑ	ab’-id-ah
Abidah	ˈæb.ɪ.dɑ	ab’-id-ah
Abidan	ˈæb.ɪ.dæn	ab’-id-an
Abiel	ˈeɪ.biˌɛl	a’-be-el
Abiezer	ˌæb.iˈi.zɚ	ab-e-e’-zur
Abiezrite	ˌæb.iˈɛz.raɪt	ab-i-ez’-rite
Abigail	ˈæbəˌgeɪl	ab’-e-gul
Abihail	ˈæbiˌheɪɪl	ab-e-ha’-il
Abihu	əˈbaɪ.hju	a-bi’-hew
Abihud	əˈbaɪ.hʌd	a-bi’-hud
Abijah	əˈbaɪ.jɑ	a-bi’-jah
Abijam	əˈbaɪ.dʒʌm	a-bi’-jum
Abilene	ˌæb.ɪˈli.ni	ab-i-le’-ne
Abimael	ˌæb.ɪˈmeɪ.ɛl	a-bim’-ah-el
Abimelech	əˈbɪm.ə.lɛk	a-bim’-e-lek
Abinadab	əˈbɪn.ə.dæb	a-bin’-ah-dab
Abiner	ˈæb.ɪ.nɚ	ab’-i-ner
Abinoam	əˈbɪn.oʊ.æm	a-bin’-o-am
Abiram	əˈbaɪ.ræm	a-bi’-rum
Abishag	ˈæb.ɪ.ʃæg	ab’-e-shag
Abishai	ˈæb.ɪ.ʃaɪ	ab’-e-shahee
Abishaloam	əˈbɪʃ.əˌlʌm	a-bish’-ah-lum
Abishua	əˈbɪʃ.uˌɑ	a-bish’-u-ah
Abishur	ˈæb.ɪ.ʃɚ	ab’-e-shur
Abital	ˈæb.ɪ.tɑl	ab’-e-tal
Abitub	ˈæb.ɪ.tʌb	ab’-e-tub
Abiud	əˈbaɪ.ʌd	a-bi’-ud
Abner	ˈæb.nɚ	ab’-nur
Abraham	ˈeɪ.brəˌhæm	a’-bra-ham
Abram	ˈeɪ.brəm	a’-brum
Abrech	ˈæb.rɛk	Ab’-rech
Absalom	ˈæb.sə.ləm	ab’-sal-um
Accad	ˈæk.kæd	ak’-kad
Accho	ˈæk.koʊ	ak’-ko
Aceldama	ˌæs.əlˈdæm.ə	as-el’-dam-ah
Achaia	ækˈeɪ.jə	ak-ah’-yah
Achaicus	ækˈeɪ.jə.kʌs	ak-ah’-yah-cus
Achan	ˈeɪ.kæn	a’-kan
Achar	ˈeɪ.kɑɹ	a’-kar
Achaz	ˈeɪ.kæz	a’-kaz
Achbor	ˈæk.bɔɹ	ak’-bor
Achim	ˈeɪ.kɪm	a’-kim
Achish	ˈeɪ.kɪʃ	a’-kish
Achmetha	ˈæk.mɛθ.ə	ak’-meth-ah
Achor	ˈeɪ.kɔɹ	a’-kor
Achsa	ˈæk.sə	ak’-sah
Achsah	ˈæk.sə	ak’-sah
Achshaph	ˈæk.ʃæf	ak’-shaf
Achzib	ˈæk.zɪb	ak’-zib
Adadah	ˈæd.ə.ə	ad’-ah-ah
Adah	ˈeɪ.də	a’-dah
Adaiah	ˈæd.aɪ.jɑ	ad-a-i’-yah
Adalia	ˈæd.əl.i.jɑ	ad-al-i’yah
Adam	ˈæd.əm	ad’-um
Adamah	ˈæd.ə.mɑ	ad’-am-ah
Adami	ˈæd.ə.mi	ad’-am-i
Adar	ˈeɪ.dɑr	a’-dar
Adar Sheni	ˈʃɛ.ni	a’-dar-she-ni
Adbeel	ˈæd.biːl	ad’-be-el
Addan	ˈæd.ən	ad’-dan
Addar	ˈæd.dɑr	ad’-dar
Addi	ˈæd.di	ad’-di
Addon	ˈæd.dɔn	ad’-don
Addulamite	əˈdʌl.əm.aɪt	a-dul’-lam-ite
Ader	ˈeɪ.dɜr	a’-dur
Adiel	ˈeɪ.diːl	a’-de-el
Adin	ˈeɪ.dɪn	a’-din
Adina	ˈæd.ɪn.ɑ	ad’-in-ah
Adino	ˈæd.ɪ.noʊ	ad’-in-o
Adithaim	ˈæd.ɪ.θeɪ.ɪm	ad-ith-a’-im
Adlai	ˈæd.laɪ	ad’-la-i
Admah	ˈæd.mɑ	ad’-mah
Admatha	ˈæd.mæθ.ɑ	ad’-math-ah
Adna	ˈæd.nɑ	ad’-nah
Adnah	ˈæd.nɑ	ad’-nah
Adonibezek	ˈæd.oʊ.nɪˈbɛ.zɛk	ad’-on-i-be’-zek
Adonijah	æd.oʊˈnaɪ.dʒɑ	ad-on-i’-jah
Adonikam	ˈæd.oʊ.nɪ.kæm	ad-on-i’-kam
Adoniram	ˈæd.oʊ.nɪ.ræm	ad-on-i’-ram
Adonizedek	ˌæd.oʊˈnaɪ.zɛ.dɛk	ad-on-i- ze’-dek
Adoraim	ˌæd.oʊˈreɪ.ɪm	ad-o-ra’-im
Adoram	ˈæd.oʊ.ræm	ad-o’-ram
Adrammelech	əˈdræm.mɛl.ɛk	a-dram’-mel-ek
Adramyttium	əˈdræm.ɪt.i.əm	a-dram-mit’-te-um
Adria	ˈeɪ.dri.ɑ	a’-dre-ah
Adriel	ˈeɪ.driˌɛl	a’-dre-el
Adullam	əˈdʌl.əm	a-dul’-lam
Adummim	əˈdʌm.ɪm	a-dum’-mim
Aeneas	ɪˈni.əs	e’-ne-as
Aenon	ˈiː.nɔn	e’-non
Agabus	ˈæg.ə.bəs	ag’-ab-us
Agag	ˈeɪ.gæg	a’-gag
Agagite	ˈæg.ə.gaɪt	ag’-ag-ite
Agar	ˈeɪ.gɑr	a’-gar
Agee	ˈæg.i	ag’-ee
Agrippa	əˈgrɪp.ə	ag-rip’-pah
Agur	ˈeɪ.gʊr	a’-gur
Ahab	ˈeɪ.hæb	a’-hab
Aharah	əˈhɑr.ə	a-har’-ah
Aharhel	əˈhɑr.hɛl	a-har’-hel
Ahasai	əˈhɑː.saɪ	a-ha’-sa-i
Ahasbai	əˈhæz.baɪ	a-has’-ba-i
Ahasuerus	əˌhæs.uˈɛ.rəs	a-has-u-e’-rus
Ahava	əˈhɑː.və	a-ha’-vah
Ahaz	ˈeɪ.hæz	a’-haz
Ahaziah	əˌhæz.iˈɑ	a-haz-i’-ah
Ahban	ˈɑː.bæn	ah’-ban
Aher	ˈeɪ.hɜr	a’-hur
Ahi	ˈeɪ.haɪ	a’-hi
Ahiah	ˈeɪ.hiː.ɑ	a’-hi-ah
Ahiam	əˈhaɪ.əm	a-hi’-am
Ahian	əˈhaɪ.ən	a-hi’-an
Ahiezer	əˈhaɪ.iː.zər	a-hi-e’-zer
Ahihud	əˈhaɪ.hʌd	a-hi’-hud
Ahijah	əˈhaɪ.dʒɑ	a-hi’-jah
Ahikam	əˈhaɪ.kæm	a-hi’-kam
Ahilud	əˈhaɪ.lʌd	a-hi’-lud
Ahimaaz	əˈhɪm.ə.æz	a-him’-a-az
Ahiman	əˈhaɪ.mən	a-hi’-man
Ahimelech	əˈhɪm.ɛ.lɛk	a-him’-el-ek
Ahimoth	əˈhaɪ.moʊθ	a-hi’-moth
Ahinadab	əˈhɪn.ə.dæb	a-hin’-ad-ab
Ahinoam	əˈhɪn.oʊ.æm	a-hin’-o-am
Ahio	əˈhaɪ.oʊ	a-hi’-o
Ahira	əˈhaɪ.rə	a-hi’-rah
Ahiram	əˈhaɪ.ræm	a-hi’-rum
Ahiramites	əˈhaɪ.rə.maɪts	a-hi’-rum-ites
Ahisamach	əˈhɪs.ə.mæk	a-his’-am-ak
Ahishahar	əˈhɪʃ.ə.hɑr	a-hish’-a-har
Ahishar	əˈhaɪ.ʃɑr	a-hi’shar
Ahithophel	əˈhɪθ.oʊ.fɛl	a-hith’-o-fel
Ahitub	əˈhaɪ.tʌb	a-hi’-tub
Ahlab	ˈɑː.læb	ah’-lab
Ahlai	ˈɑː.laɪ	ah’-lahee
Ahoah	əˈhoʊ.ə	a-ho’-ah
Ahohite	əˈhoʊ.haɪt	a-ho’-hite
Aholah	əˈhoʊ.lə	a-ho’-lah
Aholiab	əˈhoʊ.liˌæb	a-ho’-lee-ab
Aholibah	əˈhoʊ.lɪ.bə	a-hol’-ib-ah
Aholibamah	əˈhoʊ.lɪ.bəˈmɑː	a-hol’-ib-a’-mah
Ahumai	əˈhuː.maɪ	a-hoo’-mahee
Ahuzam	əˈhuː.zæm	a-hoo’-zam
Ahuzzath	əˈhʌz.əθ	a-huz’-zath
Ai	ˈaɪ	a’-i
Aiah	ˈaɪ.ə	a-i’-ah
Aiath	ˈaɪ.æθ	a-i’ath
Aija	ˈaɪ.dʒə	a-i’-jah
Aijalon	ˈaɪ.dʒə.lɔn	a-ij’-el-on
Aijeleth Shahar	ˈʃɑː.hɑr	a-ij’-el-eth sha’-har
Ain	ˈaɪn	a’-in
Ajah	ˈaɪ.dʒə	a’-jah
Ajalon	ˈædʒ.ə.lɔn	aj’-a-lon
Akan	ˈeɪ.kæn	a’-kan
Akkub	ˈæk.kʌb	ak’kub
Akrabbim	ˈæk.ræb.ɪm	ac-rab’-bim
Alameth	ˈæl.ə.mɛθ	al’-am-eth
Alammelech	ˈæl.əmˈmɛl.ɛk	a-lam’-mel-ek
Alamoth	ˈæl.ə.moʊθ	al’-am-oth
Alemeth	ˈæl.ɛ.mɛθ	al-e’-meth
Alexander	ˌæl.ɪgˈzæn.dər	al-ex-an’-dur
Alexandria (ns)	ˌæl.ɪgˈzæn.dri.ə	al-ex-an’-dree-ah
Algum	ˈæl.gʌm	al’-gum
Aliah	əˈlaɪ.ə	a-li’-ah
Alian	əˈlaɪ.ən	a-li’-un
Alleluia	ˌæl.əˈluː.jə	al-le-loo’-yah
Allon	ˈæl.ɔn	al’-lon
Allonbachuth	ˈæl.ɔnˌbækˈuːθ	al”-lon-bak’-ooth
Almighty	ɔːlˈmaɪ.ti	ol-mit’-e
Almodad	ˈæl.moʊˌdæd	al-mo’-dad
Almon	ˈæl.mɔn	al’-mon
Almondiblathaim	ˈæl.mɔnˌdɪbˈlæθ.aɪm	al’-mon-dib-lath-a’-im
Aloth	ˈeɪ.loʊθ	a’-loth
Alpha	ˈæl.fə	al’-fah
Alphaeus	ælˈfiː.əs	al-fe’-us
Altaschith	ˈæl.tæsˌkɪθ	al-tas’-kith
Alush	ˈeɪ.lʌʃ	a’-lush
Alvah	ˈæl.və	al’-vah
Alvan	ˈæl.væn	al’-vah
Amad	ˈeɪ.mæd	a’-mad
Amal	ˈeɪ.mæl	a’-mal
Amalek	ˈæm.ə.lɛk	am’-al-ek
Amalekites	ˈæm.ə.lɛk.aɪts	am’-al-ek-ites
Amam	ˈeɪ.mæm	a’-mam
Amana	ˌæm.əˈnɑː	am-a’-nah
Amariah	ˌæm.əˈraɪ.ə	am-a-ri’-ah
Amasa	ˈæm.ə.sə	am’-a-sah
Amasai	ˈæm.ə.saɪ	am’-as-ahee
Amashai	ˈæm.ə.ʃaɪ	am’-ash-ahee
Amasiah	ˌæm.əˈsaɪ.ə	am-a-si’-ah
Amaziah	ˌæm.əˈzaɪ.ə	am-a-zi’-ah
Amen	ˈeɪ.mɛn	a’-men
Amethyst	ˈæm.ə.θɪst	am’e-thyst
Ami	ˈeɪ.maɪ	a’-mi
Aminadab	əˈmɪn.ə.dæb	a-min’-a-dab
Amittai	əˈmɪt.taɪ	a-mit’-tahee
Ammah	ˈæm.ə	am’-mah
Ammi	ˈæm.i	am’-mi
Ammiel	ˈæm.iˌɛl	am’-me-el
Ammihud	ˈæm.ɪ.hʌd	am-mi’-hud
Ammihur	ˈæm.ɪ.hɜr	am-mi’-hur
Amminadab	ˈæm.ɪn.ə.dæb	am-min’-a-dab
Amminadib	ˈæm.ɪn.ə.dɪb	am-min’-a-dib
Ammishaddai	ˌæm.ɪˈʃæd.daɪ	am-mi-shad’-dahee
Ammizabad	ˈæm.ɪ.zə.bæd	am-miz’-a-bad
Ammon	ˈæm.ɔn	am’-mon
Ammonites	ˈæm.ɔn.aɪts	am’-mon-ites
Amnon	ˈæm.nɔn	am’-non
Amok	ˈeɪ.mɔk	a’-mok
Amon	ˈeɪ.mɔn	a’-mon
Amorites	ˈæm.oʊ.raɪts	am’-o-rite
Amos	ˈeɪ.moʊs	a’-mos
Amoz	ˈeɪ.moʊz	a’-moz
Amphipolis	æmˈfɪp.oʊ.lɪs	am-fip’-o-lis
Amplias	ˈæm.pli.əs	am’-ple-as
Amram	ˈæm.ræm	am’-ram
Amramites	ˈæm.ræm.aɪts	am’-ram-ites
Amraphel	ˈæm.ræf.ɛl	am’-raf-el
Amzi	ˈæm.zi	am’-zi
Anab	ˈeɪ.næb	a’-nab
Anah	ˈeɪ.nɑ	a’-nah
Anaharath	ˌæn.əˈhɑ.ræθ	an-a-ha’-rath
Anaiah	ˌæn.əˈaɪ.ə	an-a-i’-ah
Anak	ˈeɪ.næk	a’-nak
Anakims	ˈæn.ə.kɪmz	an’-ak-ims
Anamim	ˈæn.ə.mɪm	an’-am-im
Anammelech	əˈnæmˌmɛl.ɛk	a-nam’-mel-ek
Anan	ˈeɪ.næn	a’nan
Anani	ˌæn.əˈni	an-a’ni
Ananiah	ˌæn.əˈnaɪ.ə	an-an-i’-ah
Ananias	ˌæn.əˈnaɪ.əs	an-an-i’-as
Anath	ˈeɪ.næθ	a’-nath
Anathema	əˈnæθ.əm.ə	a-nath’-em-ah
Anathoth	ˈæn.əˌθɔθ	an’-a-thoth
Andrew	ˈæn.dru	an’-drew
Andronicus	ˌæn.drəˈnaɪ.kəs	an-dro-ni’-cus
Anem	ˈeɪ.nɛm	a’-nem
Aner	ˈeɪ.nɚ	a’-nur
Anethothite	ˈæn.əˌθɔθ.aɪt	an’-e-thoth-ite
Anetothite	ˈæn.əˌtɔθ.aɪt	an’-e-toth-ite
Aniam	ˈeɪ.niˌæm	a’-ne-am
Anim	ˈeɪ.nɪm	a’-nim
Anna	ˈæn.ə	an’-nah
Annas	ˈæn.əs	an’-nas
Antichrist	ˈæn.tɪˌkraɪst	an’-ti-krist
Antioch	ˈæn.tiˌɑk	an’-te-ok
Antipas	ˈæn.tɪˌpæs	an’-tip-as
Antipatris	ˌæn.tɪˈpæt.rɪs	an-tip’-at-ris
Antothijah	ænˈtɔ.θɪˌdʒɑ	an-to-thi’-jah
Antothite	ˈæn.tɔˌθaɪt	an’-to-thite
Anub	ˈeɪ.nʌb	a’-nub
Apelles	əˈpɛl.iːz	a-pel’-leze
Apharsachites	əˈfɑrˌsæk.aɪts	a-far’-sak-ites
Apharsathchites	əˈfɑrˌsæθ.kaɪts	a-far’-sath-kites
Apharsites	əˈfɑrˌsaɪts	a-far’-sites
Aphek	ˈeɪ.fɛk	a’-fek
Aphekah	ˈæf.əˌkɑ	af-e’-kah
Aphiah	ˈæf.iˌɑ	af-i’-ah
Aphik	ˈeɪ.fɪk	a’-fik
Aphrah	ˈæf.rɑ	af’-rah
Aphses	ˈæf.siːz	af’-seze
Apollonia	ˌæp.əˈləʊ.ni.ə	ap-ol-lo’-ne-ah
Apollos	əˈpɔl.əs	ap-ol’-los
Apollyon	əˈpɔl.iˌɔn	ap-ol’-le-on
Appaim	ˈæp.paɪm	ap’-pa-im
Apphia	ˈæf.i.ə	af’-fee-ah
Appii forum	ˈfɔr.əm	ap’-pe-i for’-em
Aquila	ˈæk.wɪ.lə	ac’-quil-ah
Ar	ɑr	ar
Ara	ˈeɪ.rɑ	a’-rah
Arab	ˈeɪ.ræb	a’-rab
Arabah	ˈær.ə.bɑ	ar’-ab-ah
Arabia	əˈreɪ.bi.ə	a-ra’-be-ah
Arabians	əˈreɪ.bi.ənz	a-ra’-be-un
Arad	ˈeɪ.ræd	a’-rad
Arah	ˈeɪ.rɑ	a’-rah
Aram	ˈeɪ.ræm	a’-ram
Aramitess	ˈeɪ.rəm.aɪ.tɛs	a’ram-i-tes
Aramnaharaim	ˈeɪ.ræmˌnɑ.hɑˈraɪm	a’-ram-na-ha-ra’im
Aramzobah	ˈeɪ.ræmˈzoʊ.bɑ	a’-ram-zo’-bah
Aran	ˈeɪ.ræn	a’-ran
Ararat	ˈær.ə.ræt	ar’-ar-at
Araunah	əˈrɔː.nɑ	a-raw’-nah
Arba	ˈɑr.bɑ	ar’-bah
Arbah	ˈɑr.bɑ	ar’-bah
Arbathite	ˈɑr.bæθ.aɪt	ar’-bath-ite
Arbel	ˈɑr.bɛl	ar’-bel
Arbite	ˈɑr.baɪt	ar’-bite
Archelaus	ɑrˈkɛl.ɑʊs	ar-ke-la’-us
Archevites	ˈɑr.kɪ.vaɪts	ar’-ke-vites
Archi	ˈɑr.ki	ar’-kee
Archippus	ɑrˈkɪp.əs	ar-kip’-pus
Archite	ˈɑr.kaɪt	ar’-kite
Arcturus	ɑrkˈtjʊə.rəs	ark-tu’-rus
Ard	ɑrd	ard
Ardites	ˈɑr.daɪts	ar’-dites
Ardon	ˈɑr.dɔn	ar’-don
Areli	əˈreɪ.laɪ	a-re’-li
Arelites	əˈreɪ.laɪts	a-re’-lites
Areopagite	ˈær.i.oʊˌpædʒ.aɪt	a-re-op’-a-jite
Areopagus	ˈær.i.oʊˌpæg.əs	a-re-op’-a-gus
Aretas	ˈær.ɪ.tæs	ar’-e-tas
Argob	ˈɑr.gɔb	ar’-gob
Aridai	əˈrɪd.aɪ	a-rid’-a-i
Aridatha	əˈrɪd.ə.θɑ	a-rid’-a-thah
Arieh	əˈraɪ.ɛ	a-ri’-eh
Ariel	ˈeɪ.riˌɛl	a’-re-el
Arimathaea	ˌær.ɪm.æˈθiː.ə	ar-im-ath-e’-ah
Arioch	ˈeɪɹiɒk	a’-re-ok
Arisai	əˈɹɪsəaɪ	a-ris’-a-i
Aristarchus	ˌæɹɪsˈtɑːɹkəs	ar-is-tar’-cus
Aristobulus	əˈɹɪstəˌbjuːləs	a-ris-to-bu’-lus
Arkite	ˈɑːɹkaɪt	ar’-kite
Armageddon	ɑːɹˈmæɡədɒn	ar-mag-ed’-don
Armenia	ɑːɹˈmiːniə	ar-me’-ne-ah
Armoni	ɑːɹˈmoʊni	ar-mo’-ni
Arnan	ˈɑːɹnæn	ar’-nan
Arni	ˈɑːɹni	ar’-ni
Arnon	ˈɑːɹnɒn	ar’-non
Arod	ˈeɪɹɒd	a’-rod
Arodi	ˈæɹoʊdaɪ	ar’-o-di
Arodites	ˈeɪɹoʊdaɪts	a’-ro-dites
Aroer	ˈæɹoʊɚ	ar’-o-ur
Aroerite	ˈæɹoʊɚaɪt	ar’-o-ur-ite
Arpad	ˈɑːɹpæd	ar’-pad
Arphad	ˈɑːɹfæd	ar’-fad
Arphaxad	ɑːɹˈfæksæd	ar-fax’-ad
Artaxerxes	ɑːɹˈtæksɚksiːz	ar-tax-erx’-ees
Artemas	ˈɑːɹtəmæs	ar’-te-mas
Aruboth	ˈɑːɹjuːbɒθ	ar’-u-both
Arumah	əˈɹuːmə	a-ru’-mah
Arvad	ˈɑːɹvæd	ar’-vad
Arvadites	ˈɑːɹvədaɪts	ar’-vad-ites
Arza	ˈɑːɹzə	ar’-zah
Asa	ˈeɪsə	a’-sah
Asahel	ˈæsəˌhɛl	as’-a-hel
Asahiah	æsəˈhaɪə	as-a-hi’-ah
Asaiah	æsəˈjaɪə	as-a’-yah
Asaph	ˈeɪsæf	a’-saf
Asareel	əˈsærɪˌɛl	a-sar’-e-el
Asarelah	əˈsærɪˌlɑː	as-a-re’-lah
Asenath	ˈæsɪˌnæθ	as’-e-nath
Aser	ˈeɪsɚ	a’-sur
Ashan	ˈeɪʃæn	a’-shan
Ashbea	ˈæʃbiə	ash’-be-ah
Ashbel	ˈæʃbəl	ash’-bel
Ashbelites	ˈæʃbəlaɪts	ash’-bel-ites
Ashchenaz	ˈæʃkɪnæz	ash’-ke-naz
Ashdod	ˈæʃdɒd	ash’-dod
Ashdodites	ˈæʃdɒdaɪts	ash’-dod-ites
Ashdoth	ˈæʃdɒθ	ash’-doth
Ashdothites	ˈæʃdɒθaɪts	ash’-doth-ites
Ashdothpisgah	ˈæʃdoʊθˌpɪzgɑː	ash’doth-piz’gah
Asher	ˈæʃɚ	ash’-ur
Asherah	æˈʃɪɹə	ashe’-rah
Asherites	ˈæʃɚaɪts	ash’-ur-ites
Ashima	ˈæʃɪmə	ash’-im-ah
Ashkelon	ˈæʃkɪlɒn	ash’-ke-lon
Ashkenaz	ˈæʃkɪnæz	ash’-ke-naz
Ashnah	ˈæʃnə	ash’-nah
Ashpenaz	ˈæʃpɪnæz	ash’-pe-naz
Ashriel	ˈæʃɹiˌɛl	ash’-re-el
Ashtaroth	ˈæʃtəˌɹɒθ	ash’-ta-roth
Ashterathite	ˈæʃtəˌɹæθaɪt	ash’-ter-a-thite
Ashteroth	ˈæʃtəˌɹɒθ	ash’-ta’roth
Ashteroth Karnaim	kɑːɹˈnaɪm	ash’-te-roth kar-na-im
Ashterothite	ˈæʃtəˌɹɒθaɪt	ash’-ter-o-thite
Ashtoreth	ˈæʃtoʊˌrɛθ	ash’-to-reth
Ashur	ˈæʃɚ	ash’-ur
Ashurites	ˈæʃɚaɪts	ash’-ur-ites
Ashvath	ˈæʃvæθ	ash’-vath
Asia	ˈeɪʃə	a’-she-ah
Asiel	ˈeɪsiˌɛl	a’-se’-el
Askelon	ˈæskɪlɒn	as’-ke-lon
Asnah	ˈæsnə	as’-nah
Asnapper	ˈæsnæpɚ	as-nap’-pur
Aspatha	ˈæspəˌθɑː	as’-pa-thah
Asriel	ˈæsɹiˌɛl	as’-re-el
Asrielites	ˈæsɹiˌɛlaɪts	as’-re-el-ites
Asshur	ˈæʃɚ	ash’-ur
Asshurim	ˈæʃʊɹɪm	ash’-u-rim
Assir	ˈæsɪɹ	as’-sur
Assos	ˈæsɒs	as’-sos
Assur	ˈæsɚ	as’-sur
Assyria	əˈsɪɹiə	as-sir’-e-ah
Assyrians	əˈsɪɹiənz	as-sir’-e-uns
Astaroth	ˈæstəˌɹɒθ	as’-ta-roth
Asuppim	əˈsʌpɪm	asup’-pim
Asyncritus	əˈsɪnkrɪtəs	a-sin’-cri-tus
Atad	ˈeɪtæd	a’-tad
Atarah	ˈætəˌɹɑː	at’-a-rah
Ataroth	ˈætəˌɹɒθ	at’-a-roth
Atarothadar	ˈætəˌɹɒθəˈdɑːɹ	at’-a-roth-a’-dar
Atarothaddar	ˈætəˌɹɒθˈædɑːɹ	at’-a-roth-ad’-dar
Ater	ˈeɪtɚ	a’-tur
Athach	ˈeɪθæk	a’-thak
Athaiah	æθəˈaɪə	ath-a-i’-ah
Athaliah	æθəˈlaɪə	ath-a-li’-ah
Athenains	æˈθiːniənz	a-the’-ne-uns
Athens	ˈæθɪnz	ath’-ens
Athlai	ˈæθlaɪ	ath’-lahee
Atroth	ˈeɪtɹɒθ	a’-troth
Attai	ˈætaɪ	at’-tahee
Attalia	ætəˈlaɪə	at-ta-li’-ah
Augustus	ɔːˈɡʌstəs	aw-gus’-tus
Ava	ˈeɪvə	a’-vah
Aven	ˈeɪvɛn	a’-ven
Avim	ˈeɪvɪm	a’-vim
Avites	ˈeɪvaɪts	a’-vites
Avith	ˈeɪ.vɪθ	a’-vith
Azal	ˈeɪ.zæl	a’-zal
Azaliah	ˌæz.əˈlaɪ.ə	az-a-li’-ah
Azaniah	ˌæz.əˈnaɪ.ə	az-a-ni’-ah
Azarael	əˈzær.ə.ɛl	a-zar’-a-el
Azareel	əˈzær.iːl	a-zar’-e-el
Azariah	ˌæz.əˈraɪ.ə	az-a-ri’-ah
Azaz	ˈeɪ.zæz	a’-zaz
Azazel	əˈzeɪ.zɛl	a-za’-zel
Azaziah	ˌæz.əˈzaɪ.ə	az-a-zi’-ah
Azbuk	ˈæz.bʊk	az’-buk
Azekah	əˈziː.kə	a-ze’-kah
Azel	ˈeɪ.zɛl	a’-zel
Azem	ˈeɪ.zɛm	a’-zem
Azgad	ˈæz.ɡæd	az’-gad
Aziel	əˈziː.ɛl	a’-ze-el
Aziza	əˈziː.zə	a-zi’-zah
Azmaveth	ˈæz.mə.vɛθ	az-ma’-veth
Azmon	ˈæz.mɒn	az’-mon
Aznothtabor	ˈæz.nɒθˈteɪ.bɔːr	az’-noth-ta’-bor
Azor	ˈeɪ.zɔːr	a’zor
Azotus	əˈzoʊ.təs	a-zo’-tus
Azriel	ˈæz.ri.ɛl	az’-re-el
Azrikam	ˈæz.rɪ.kæm	az’-ri-kam
Azubah	əˈzuː.bə	a-zu’-bah
Azur	ˈeɪ.zʊr	a’-zur
Azzah	ˈæz.ə	az’-zah
Azzan	ˈæz.æn	az’-zan
Azzur	ˈæz.ʊr	az’-zur
Baal	ˈbɑː.æl	ba’-al
Baalah	ˈbɑː.æl.ə	ba’-al-ah
Baalath	ˈbɑː.æl.æθ	ba’-al-ath
Baalathbeer	ˈbɑː.æl.æθˈbiː.ər	ba’-al-ath-be’-ur
Baalberith	ˈbɑː.ælˈbɛr.ɪθ	ba’-al-be’rith
Baale	ˈbɑː.æl.eɪ	ba’-al-eh
Baalgad	ˈbɑː.ælˈɡæd	ba’-al-gad’
Baalhamon	ˈbɑː.ælˈhæ.mɒn	ba’-al-ha’-mon
Baalhanan	bɑː.ælˈhæ.næn	ba-al-ha’-nan
Baalhazor	ˈbɑː.ælˈhæ.zɔːr	ba’-al-ha’-zor
Baalhermon	ˈbɑː.ælˈhɜːr.mɒn	ba’-al-her’-mon
Baali	ˈbɑː.æl.i	ba’-al-i
Baalim	ˈbɑː.æl.ɪm	ba’-al-im
Baalis	ˈbɑː.æl.ɪs	ba’-al-is
Baalmeon	ˈbɑː.ælˈmiː.ɒn	ba’-al-me’-on
Baalpeor	ˈbɑː.ælˈpiː.ɔːr	ba’-al-pe’-or
Baalperazim	ˈbɑː.ælˈpɛr.ə.zɪm	ba’-al-per’-a-zim
Baalshalisha	ˈbɑː.ælˈʃæl.ɪ.ʃə	ba’-al-shal’-i-shah
Baaltamar	ˈbɑː.ælˈtæ.mɑːr	ba’-al-ta’-mar
Baalzebub	ˈbɑː.ælˈzɛ.bʌb	ba’-al-ze’-bub
Baalzephon	ˈbɑː.ælˈzɛ.fɒn	ba’-al-ze’-fon
Baana	ˈbɑː.æn.ə	ba’-an-ah
Baanah	ˈbɑː.æn.ə	ba’-an-ah
Baara	ˈbɑː.ɑːr.ə	ba’-ar-ah
Baaseiah	bɑː.æsˈiː.ə	ba-as-i’-ah
Baasha	ˈbɑː.æʃ.ə	ba’-ash-ah
Babel	ˈbæ.bɛl	ba’-bel
Babylon	ˈbæb.ɪ.lʌn	bab’-il-un
Babylonians	ˌbæb.ɪˈloʊ.ni.əns	bab-il-o’-ne-ans
Babylonish	ˈbæb.ɪˈloʊ.nɪʃ	bab-il-o’-nish
Baca	ˈbɑː.kə	ba’-cah
Bachrites	ˈbæk.raɪts	bak’-rites
Baharumite	bəˈhɑː.rʊm.aɪt	ba-ha’-rum-ite
Bahurim	bəˈhuː.rɪm	ba-hu’-rim
Bajith	ˈbɑː.dʒɪθ	ba’-jith
Bakbakkar	bækˈbæk.kɑːr	bak-bak’-kar
Bakbuk	ˈbæk.bʌk	bak’-buk
Bakbukiah	bækˈbʌk.i.ə	bak-buk-i’-ah
Balaam	ˈbɑː.læm	ba’-la-am
Balac	ˈbɑː.læk	ba’-lak
Baladan	ˈbæl.ə.dæn	bal’-adan
Balah	ˈbɑː.lə	ba’-lah
Balak	ˈbɑː.læk	ba’-lak
Bamah	ˈbɑː.mə	ba’-mah
Bamoth	ˈbɑː.mɒθ	ba’-moth
Bamothbaal	ˈbɑː.mɒθˈbɑː.æl	ba’-moth-ba’-al
Bani	ˈbɑː.ni	ba’-ni
Baptist	ˈbæp.tɪst	bap’-tist
Barabbas	bəˈræb.əs	ba-rab’-bas
Barachel	ˈbær.ə.kɛl	bar’-ak-el
Barachias	ˈbær.əˈkaɪ.əs	bar’-ak-i’-as
Barak	ˈbɑː.ræk	ba’-rak
Barhumite	ˈbɑːr.huː.maɪt	bar’-hu-mite
Bariah	bəˈraɪ.ə	ba-ri’-ah
Barjesus	bɑːrˈdʒiː.səs	bar-je’-sus
Barjona	bɑːrˈdʒoʊ.nə	bar-jo’-nah
Barkos	ˈbɑːr.kɒs	bar’-cos
Barnabas	ˈbɑːr.nə.bəs	bar’-na-bas
Barsabas	ˈbɑːr.sə.bəs	bar’-sab-as
Bartholomew	ˈbɑːr.θəˈloʊ.mjuː	bar-thol’-o-mew
Bartimaeus	bɑːrˈtaɪ.miː.əs	bar-ti-me’-us
Baruch	ˈbɑː.rʊk	ba’-rook
Barzillai	bɑːrˈzɪl.aɪ	bar-zil’-la-i
Bashan	ˈbɑː.ʃæn	ba’-shan
Bashanhavothjair	bɑːˈʃæn.hæˈvɒθ.dʒaɪ.ər	ba”-shan-ha’-voth-ja’-ur
Bashemath	ˈbæʃ.ɪ.mæθ	bash’-e-math
Basmath	ˈbæs.mæθ	bas’-math
Bathrabbim	bæθˈræb.ɪm	bath-rab’-bim
Bathsheba	ˈbæθ.ʃiː.bə	bath’-she-bah
Bathshua	ˈbæθ.ʃuː.ə	bath’-shu-ah
Bavai	ˈbæv.aɪ	bav’-a-i
Bazlith	ˈbæz.lɪθ	baz’-lith
Bazluth	ˈbæz.luːθ	baz’-luth
Bdellium	ˈbdɛl.i.əm	bdel’-li-um
Bealiah	biˈæl.i.ə	be-a-li’-ah
Bealoth	ˈbiː.ə.lɒθ	be’-a-loth
Bebai	ˈbɛb.aɪ	beb’-a-i
Becher	ˈbɛk.ər	be’-ker
Bechorath	bɛˈkoʊ.ræθ	be-ko’-rath
Bedad	ˈbɛ.dæd	be’-dad
Bedan	ˈbɛ.dæn	be’-dan
Bedeiah	bɛˈdaɪ.ə	be-de’-yah
Beeliada	biːˈɛl.iˈæd.ə	be-e-li’-ad-ah
Beelzebub	biːˈɛlz.ə.bʌb	be-el’-ze-bub
Beer	ˈbiː.ər	be’-ur
Beera	ˈbiːr.ə	be-e’-rah
Beerah	ˈbiːr.ə	be-e’-rah
Beerelim	ˈbɛ.ʊr.ɛˈlɪm	be’-ur-e’-lim
Beeri	ˈbiː.ɛˈri	be-e’-ri
Beerlahairoi	ˈbɛ.ʊr.lɑˈhɑ.heˈroʊ.i	be’-ur-la’-hahe-ro’-e
Beeroth	ˈbiː.ɛˈroʊθ	be-e’-roth
Beerothite	biˈɛr.oʊˌθaɪt	be-er’-o-thite
Beersheba	ˈbiː.ɚˈʃɛbə	be-ur’-she-bah
Beeshterah	biˈɛʃˈtɛrə	be-esh’-te-rah
Behemoth	ˈbɛ.hɛˈmɒθ	be’-he-moth
Bekah	ˈbɛˈkɑ	be’-kah
Bel	bɛl	bel
Bela	ˈbɛˈlɑ	be’-lah
Belah	ˈbɛˈlɑ	be’-lah
Belaites	ˈbɛˈlɑ.aɪts	be’-lah-ites
Belial	ˈbiː.li.ˌæl	be’-le-al
Belshazzar	bɛlˈʃæzˈɑr	bel-shaz’-ar
Belteshazzar	bɛlˈtɛʃˌæzˈɑr	bel-te-shaz’-ar
Ben	bɛn	ben
Benaiah	ˌbɛn.eɪˈɑ	ben-ay’-ah
Benammi	bɛnˈæmˌmi	ben-am’-mi
Beneberak	ˈbɛ.nɛˈbɛˈræk	be’-ne-be’-rak
Benejaakan	ˈbɛ.nɛˈʤɑˈəˈkæn	be’-ne-ja’-a-kan
Benhadad	ˈbɛnˈhɑˈdæd	ben’-ha-dad
Benhail	ˌbɛnˈhaɪl	ben-ha’-il
Benhanan	bɛnˈhænən	ben-ha’-nan
Beninu	ˈbɛnˈɪˌnu	ben’-i-nu
Benjamin	ˈbɛnʤəmɪn	ben’-ja-min
Benjamites	ˈbɛnʤəˌmaɪts	ben’-ja-mite
Beno	ˈbɛˈnoʊ	be’-no
Benoni	bɛnˈoʊˌni	ben-o’-ni
Benzoheth	bɛnˈzoʊˌhɛθ	ben-zo’-heth
Beon	ˈbɛˈɒn	be’-on
Beor	ˈbiːˈɔr	be’-or
Bera	ˈbɛˈrɑ	be’-rah
Berachah	ˈbɛrˈɑˌkɑ	ber’-a-kah
Berachiah	ˌbɛrəˈkaɪə	ber-a-ki’-ah
Beraiah	ˌbɛrˈaɪə	ber-a-i’-ah
Berea	bɪˈriːə	be-re’-a
Berechiah	bɛrˈɛkaɪə	ber-e-ki’-ah
Bered	ˈbɛˈrɛd	be’-red
Beri	ˈbɛˈri	be’-ri
Beriah	bɛˈraɪə	be-ri’-ah
Beriites	bɛˈraɪˌaɪts	be-ri’-ites
Berites	ˈbɛˈraɪts	be’-rites
Berith	ˈbɛˈrɪθ	be’-rith
Bernice	bɜrˈnaɪˈsi	bur-ni’-see
Berodachbaladan	ˌbɛroʊˈdækˌbælˈædən	ber-o’-dak-bal’-ad-an
Berothah	bɛˈroʊˌθɑ	ber-o’-thah
Berothai	ˈbɛrˌoʊˈθaɪ	ber’-o-thahee
Berothite	ˈbɛˈroʊˌθaɪt	be’-ro-thite
Beryl	ˈbɛrɪl	ber’-yl
Besai	ˈbɛˈsaɪ	be’-sahee
Besodeiah	ˌbɛsoʊˈdaɪə	bes-o-di’-ah
Besor	ˈbɛˈsɔr	be’-sor
Betah	ˈbɛˈtɑ	be’-tah
Beten	ˈbɛˈtɛn	be’-ten
Bethabara	ˈbɛθˌæbˈɑrə	beth-ab’-ar-ah
Bethanath	ˈbɛθˈænəθ	beth’-a-nath
Bethanoth	ˈbɛθˈænɒθ	beth’-a-noth
Bethany	ˈbɛθəni	beth’-a-ny
Betharabah	ˈbɛθəˈræbə	beth-ar’-ab-ah
Betharam	ˈbɛθˈærəm	beth’-a-ram
Betharbel	ˈbɛθˌɑrˈbɛl	beth-ar’-bel
Bethaven	ˈbɛθˈævɛn	beth-a’-ven
Bethazmaveth	ˈbɛθˌæzˈmævɛθ	beth-az’-maveth
Bethbaalmeon	ˌbɛθˈbælˌmiːˈɒn	beth-be’-al-me’-on
Bethbarah	ˈbɛθˈbærə	beth-ba’-rah
Bethbirei	ˈbɛθˌbɪˈreɪ.i	beth-bir-e-i
Bethcar	ˈbɛθˈkɑr	beth’-car
Bethdagon	ˈbɛθˈdæɡɒn	beth-da’-gon
Bethdiblathaim	ˈbɛθˌdɪbləˈθaɪm	beth-dib-lath-a’-im
Bethel	ˈbɛθˈɛl	beth’-el
Bethelite	ˈbɛθˈɛlaɪt	beth’-el-ite
Bethemek	ˈbɛθˈɛmɛk	beth-e’-mek
Bether	ˈbɛˈθɜr	be’-thur
Bethesda	ˈbɛθˈɛzdə	beth-ez’-dah
Bethezel	ˈbɛθˈɛzɛl	beth-e’-zel
Bethgader	ˈbɛθˈɡeɪdər	beth-ga’-der
Bethgamul	ˈbɛθˈɡæmʊl	beth-ga’-mul
Bethhaccerem	ˈbɛθˌhækˈsɛrɛm	beth-hak’-se-rem
Bethharan	ˈbɛθˈhærən	beth-ha’-ran
Bethhogla	ˈbɛθˈhɒɡlə	beth-hog’-lah
Bethhoglah	ˈbɛθˈhɒɡlə	beth-hog’-lah
Bethhoron	ˈbɛθˈhɔrɒn	beth-ho’-ron
Bethjeshimoth	ˈbɛθˈdʒɛʃɪˌmɒθ	beth-jesh’-im-oth
Bethjesimoth	ˈbɛθˈdʒɛsɪˌmɒθ	beth-jes’-im-oth
Bethlebaoth	ˈbɛθˌlɛbˈaɪ.ɒθ	beth-leb’-a-oth
Bethlehem	ˈbɛθˌlɪˈhɛm	beth’-le-hem
Bethlehemite	ˈbɛθˌlɪˈhɛmaɪt	beth’-le-hem-ite
Bethlehemjudah	ˈbiː.ər.ɪˌlɪm	beth’-le-hem-ju’-dah
Bethmaachah	ˈbiː.ɛˈri	beth-ma’-a-kah
Bethmarcaboth	ˈbiː.ər.lɑˈhaɪ.roʊˈi	beth-mar’-cab-oth
Bethmeon	ˈbiː.ər.oʊθ	beth-me’-on
Bethnimrah	biːˈɛr.əˌθaɪt	beth-nim’-rah
Bethpalet	ˈbiːr.ʃɛb.ə	beth-pa’-let
Bethpazzez	ˈbiːʃ.tɛr.ɑ	beth-paz’-zez
Bethpeor	ˈbɛ.hɪ.mɒθ	beth-pe’-or
Bethphage	ˈbɛ.kɑ	beth’-fa-je
Bethphelet	bɛl	beth’-fe-let
Bethrapha	ˈbɛ.lɑ	beth’-ra-fah
Bethrehob	ˈbɛ.lɑ	beth’-re-hob
Bethsaida	ˈbɛ.lɑˌaɪts	beth-sa’-dah
Bethshan	ˈbiː.li.æl	beth’-shan
Bethshean	ˈbɛl.ʃæz.ɑr	beth-she’-an
Bethshemesh	ˈbɛl.tɛˈʃæz.ɑr	beth’-she-mesh
Bethshemite	bɛn	beth’-shem-ite
Bethshittah	bɛnˈaɪ.ə	beth-shit’-tah
Bethtappuah	bɛnˈæm.i	beth-tap’-pu-ah
Bethuel	ˈbɛn.iˈbɛr.æk	beth-u’-el
Bethul	ˈbɛn.iˈʤɑː.kən	beth’-ul
Bethzur	ˈbɛn.hɑˈdæd	beth’-zur
Betonim	ˈbɛn.haɪl	bet’-o-nim
Beulah	bɛnˈhæn.ən	be-u’-lah
Bezai	ˈbɛn.ɪˌnuː	be’-zahee
Bezaleel	ˈbɛn.dʒə.mɪn	be-zal’-e-el
Bezek	ˈbɛn.dʒəˌmaɪts	be’-zek
Bezer	ˈbɛ.noʊ	be’-zer
Bichri	bɛˈnoʊ.ni	bik’-ri
Bidkar	bɛnˈzoʊ.hɛθ	bid’-kar
Bigtha	ˈbiː.ɒn	big’-thah
Bigthan	ˈbiː.ɔr	big’-than
Bigthana	ˈbɛ.rɑ	big’-than-ah
Bigvai	bɛˈrɑː.kɑ	big’-vahee
Bildad	bɛˈraɪ.ki.ɑ	bil’-dad
Bileam	bɛˈraɪ.ɑ	bil’-e-am
Bilgah	bɪˈriː.ɑ	bil’-gah
Bilgai	bɛˈrɛk.i.ɑ	bil’-gahee
Bilhah	ˈbɛ.rɛd	bil’-hah
Bilhan	ˈbɛ.ri	bil’-han
Bilshan	bɛˈraɪ.ɑ	bil’-shan
Bimhal	bɛˈraɪ.ɪts	bim’-hal
Binea	ˈbɛ.rɪts	bin’-e-ah
Binnui	ˈbɛ.rɪθ	bin’-nu-ee
Birsha	bɜːˈniː.si	bur’-shah
Birzavith	ˌbɛr.əˈdæk.bɑlˈæd.ən	bur’-za-vith
Bishlam	bɛˈroʊ.θɑ	bish’-lam
Bithiah	ˈbɛr.oʊˈθaɪ	bith-i’-ah
Bithron	ˈbɛr.oʊˌθaɪt	bith’-ron
Bithynia	ˈbɛr.ɪl	bith-in’-e-ah
Bizjothjah	ˈbɛ.saɪ	biz-joth’-jah
Biztha	ˌbɛs.oʊˈdaɪ.ə	biz’-thah
Blastus	ˈbɛ.sɔr	blas’-tus
Boanerges	ˈbɛ.tɑ	bo-an-er’-jees
Boaz	ˈbɛ.tɛn	bo’-az
Bocheru	ˌbɛθ.ˈæb.ə.rɑ	bok’-er-u
Bochim	ˈbɛθ.əˌnæθ	bo’-kim
Bohan	ˈbɛθ.əˌnɒθ	bo’-han
Booz	ˈbɛθ.əˌni	bo’-oz
Boscath	ˌbɛθ.ˈær.əˌbɑ	bos’-cath
Bosor	ˈbɛθ.əˌræm	bo’-sor
Bozez	ˈbɛθ.ˈɑr.bɛl	bo’-zez
Bozkath	ˈbɛθ.ˈæv.ɛn	boz’-kath
Bozrah	ˈbɛθ.æzˈmæv.ɛθ	boz’-rah
Bukki	ˈbɛθ.bælˈmiː.ɒn	buk’-ki
Bukkiah	ˈbɛθ.bɑˈrɑ	buk-ki’-ah
Bul	ˈbɛθ.bɪˈreɪ.i	bul
Bunah	ˈbɛθ.kɑr	boo’-nah
Bunni	ˈbɛθˈdɑˌɡɒn	bun’-ni
Buz	ˈbɛθˌdɪb.ləˈθaɪm	buz
Buzi	ˈbɛθ.ɛl	boo’-zi
Buzite	ˈbɛθ.ɛl.aɪt	boo’-zite
Cabbon	ˈbɛθ.ɛˌmɛk	cab’-bon
Cabul	ˈbɛ.θɜr	ca’-bul
Caesar	ˈbɛθ.ɛzˈdɑ	se’-zur
Caesar Augustus	ˈbɛθ.ɛˈzɛl	se’-zur aw-gus’-tus
Caesarea	ˈbɛθ.ɡeɪ.dɜr	ses-a-re’-ah
Caesarea Philippi	ˈbɛθ.ɡɑˈmʊl	ses-a-re’-ah fil-ip’-pi
Caiaphas	ˈbɛθ.hækˈsɛr.ɛm	cah’-ya-fus
Cain	ˈbɛθ.hɑˈræn	cain
Cainan	ˈbɛθ.hɒɡ.lə	ca’-nun
Calah	ˈbɛθ.hɒɡ.lə	ca’-lah
Calamus	ˈbɛθ.hoʊˈrɒn	cal’-a-mus
Calcol	ˈbɛθ.dʒɛˈʃɪ.mɒθ	cal’-col
Caleb	ˈbɛθ.dʒɛˈsɪ.mɒθ	ca’-leb
Calebephratah	ˈbɛθ.lɛˈbɑː.ɒθ	ca’-leb-ef’-ra-tah
Calneh	ˈbɛθˌlɪˈhɛm	cal’-neh
Calno	ˈbɛθˌlɪˈhɛm.aɪt	cal’-no
Calvary	ˈbɛθˌlɪˈhɛmˌdʒuˈdɑ	cal’-va-ry
Camon	ˈbɛθˈmɑːˌɑː.kɑ	ca’-mon
Cana	ˈbɛθˈmɑːrˌkæb.ɒθ	ca’-nah
Canaan	ˈbɛθˈmiː.ɒn	ca’-na-an
Canaanites	ˈbɛθˈnɪm.rɑ	ca’-na-an-ites
Canaanitish	ˈbɛθˈpæl.ɛt	ca’-na-an-i-tish
Candace	ˈbɛθˌpæzˈzɛz	can’-da-see
Canneh	ˈbɛθˈpiːɔr	can’-neh
Capernaum	ˈbɛθˈfeɪʤi	ca-pur’-na-um
Caphthorim	ˈbɛθˈfɛlɛt	caf’-tho-rim
Caphtor	ˈbɛθˈrɑːfɑ	caf’-tor
Caphtorim	ˈbɛθˈriːhɒb	caf’-to-rim
Cappadocia	ˈbɛθˈsaɪdɑ	cap-pa-do’-she-ah
Carbuncle	ˈbɛθˈʃæn	car’-bun-cle
Carcas	ˈbɛθˈʃiːæn	car’-cas
Carchemish	ˈbɛθˈʃɛmɛʃ	car’-ke-mish
Careah	ˈbɛθˈʃɛmaɪt	ca-re’-ah
Carmel	ˈbɛθˈʃɪtɑ	car’-mel
Carmelite	ˈbɛθˈtæpjuɑ	car’-mel-ite
Carmelitess	ˈbɛθjuˌɛl	car’-mel-i-tess
Carmi	ˈbɛθʌl	car’-mi
Carmites	ˈbɛθˈzʊr	car’-mites
Carpus	ˈbɛtəˌnɪm	car’-pus
Carshena	ˈbjuːlɑ	car-she’-nah
Casiphia	ˈbeɪˈzaɪ	cas-if’-e-ah
Casluhim	ˈbɛzəˌliːl	cas’-loo-him
Castor	ˈbɛzɛk	cas’-tor
Cedron	ˈbɛzɚ	se’-drun
Cenchrea	ˈbɪkˌraɪ	sen’-kre-ah
Cephas	ˈbɪdˌkɑr	se’-fas
Chalcedony	ˈbɪɡˌθɑ	chal-ced’-o-ny
Chalcol	ˈbɪɡˌθæn	kal’-kol
Chaldaeans	ˈbɪɡˌθɑnɑ	kal-de’-uns
Chaldea	ˈbɪɡˈvaɪ	kal-de’-ah
Chaldees	ˈbɪlˌdæd	kal’-dees
Chanaan	ˈbɪlˈiːæm	ka’-na-un
Chapmen	ˈbɪlˌɡɑ	chap’-men
Charashim	ˈbɪlˈɡaɪ	car’-a-shim
Charchemish	ˈbɪlˌhɑ	car’-ke-mish
Charran	ˈbɪlˌhæn	car’-ran
Chebar	ˈbɪlˌʃæn	ke’-bar
Chedorlaomer	ˈbɪmˌhæl	ke’-dor-la’-o-mer
Chelal	ˈbɪnˌiːɑ	ke’-lal
Chelluh	ˈbɪnˌjuːi	kel’-loo
Chelub	ˈbɜːrˌʃɑ	ke’-lub
Chelubai	ˈbɜːrˌzævɪθ	ke-loo’-bahee
Chemarims	ˈbɪʃˌlæm	kem’-a-rims
Chemosh	bɪˈθaɪɑ	ke’-mosh
Chenaanah	ˈbɪθˌrɒn	ke-na’-a-nah
Chenani	bɪˈθɪnɪɑ	ken’-a-ni
Chenaniah	bɪzˈdʒɒθˌdʒɑ	ken-a-ni’-ah
Chepharhaammonai	ˈbɪzˌθɑ	ke’-far-ha-am’-mo-nahee
Chephirah	ˈblæsˌtʌs	ke-fi’-rah
Cheran	ˌboʊænˈɜːrdʒiːz	ke’-ran
Cherethims	ˈboʊˌæz	ker’-e-thims
Cherethites	ˈboʊkəˌruː	ker’-e-thites
Cherith	ˈboʊˌkɪm	ke’-rith
Cherub	ˈboʊˌhæn	ke’-rub
Cherubim	ˈboʊˌɒz	cher’-u-bims
Chesalon	ˈbɒsˌkæθ	kes’-a-lon
Chesed	ˈboʊˌsɔr	ke’-sed
Chesil	ˈboʊˌzɛz	ke’-sil
Chesulloth	ˈboʊzˌkæθ	ke-sul’-loth
Chezib	ˈboʊzˌrɑ	ke’-zib
Chidon	ˈbʊkˌkiː	ki’-don
Chileab	bʊˈkɪjɑ	kil’-e-ab
Chilion	bʊl	kil’-e-on
Chilmad	ˈbuːnɑ	kil’-mad
Chimham	ˈbʌnˌniː	kim’-ham
Chinhan	bʌz	kin’-ham
Chinnereth	ˈbuːziː	kin’-ne-reth
Chinneroth	ˈbuːzaɪt	kin’-ne-roth
Chios	ˈkæbˌɒn	ki’-os
Chisleu	ˈkæbʌl	kis’-lew
Chislon	ˈsiːzɚ	kis’-lon
Chislothtabor	ˈsiːzɚ ɔːˈɡʌstʌs	kis’-loth-ta’-bor
Chittim	ˌsɛsəˈriːɑ	kit’-tim
Chiun	ˌsɛsəˈriːɑ fɪˈlɪpi	ki’-un
Chloe	ˈkaɪəfəs	clo’-e
Chorashan	keɪn	cor-a’-shan
Chorazin	ˈkeɪnən	co-ra’-zin
Chozeba	ˈkeɪlɑ	ko-ze’-bah
Christ	ˈkæləməs	krist
Christians	ˈkælkɒl	kris’-tyans
Chrysolyte	ˈkraɪ.sə.laɪt	chry’-so-lyte
Chrysoprasus	ˈkraɪ.səˌpræ.səs	chry’-so-pra’-sus
Chub	kʌb	cub
Chun	kʌn	kun
Chushanrishathaim	ˈkuː.ʃænˌrɪʃ.əˈθaɪ.ɪm	cu’-shan-rish-a-tha’-im
Chuza	ˈkuː.zə	cu’-zah
Cilicia	sɪˈlɪʃ.jə	sil-ish’-yah
Cinneroth	ˈsɪn.əˌrɒθ	sin’-ne-roth
Cis	sɪs	sis
Clauda	ˈklɔː.də	claw’-dah
Claudia	ˈklɔː.di.ə	claw’-de-ah
Claudius	ˈklɔː.di.əs	claw’-de-us
Claudius Lysias	ˈklɔː.di.əs ˈlɪs.i.æs	claw’-de-us lis’-e-as
Clement	ˈklɛm.ənt	clem’-ent
Cleopas	ˈkliː.oʊ.pæs	cle’-o-pas
Cleophas	ˈkliː.oʊ.fæs	cle’-o-fas
Cnidus	ˈnaɪ.dəs	ni’-dus
Colhozeh	ˈkɒl.hoʊˌzɛ	col-ho’-zeh
Colosse	kəˈlɒs.i	co-los’-see
Colossians	kəˈlɒʃ.ənz	co-los’-yuns
Conaniah	koʊˈnæ.ni.ə	co-na-ni’-ah
Coniah	koʊˈnaɪ.ə	co-ni’-ah
Cononiah	koʊˈnoʊ.ni.ə	co-no-ni’-ah
Coos	ˈkoʊ.ɒs	co’-os
Coral	ˈkoʊ.ræl	co’-ral
Core	ˈkoʊ.riː	co’-ree
Corinth	ˈkɔːr.ɪnθ	cor’-inth
Corinthians	kɔːˈrɪn.θi.ənz	co-rin’-the-uns
Corinthus	kɔːˈrɪn.θəs	co-rin’-thus
Cornelius	kɔːrˈniː.li.əs	cor-ne’-le-us
Cosam	ˈkoʊ.sæm	co’-sam
Coz	kɒz	coz
Cozbi	ˈkɒz.bi	coz’-bi
Crescens	ˈkrɛs.əns	cres’-sens
Crete	kriːt	creet
Cretes or Cretians	ˈkriː.ʃənz	cre’-shuns
Crispus	ˈkrɪs.pəs	cris’-pus
Cumi	ˈkuː.mi	coo’-mi
Cush	kʌʃ	cush
Cushan	ˈkuː.ʃæn	cu’-shan
Cushi	ˈkuː.ʃi	cu’-shi
Cuth	kʌθ	cuth
Cuthah	ˈkuː.θə	cu’-thah
Cyprus	ˈsaɪ.prəs	si’-prus
Cyrene	saɪˈriː.ni	si-re’-ne
Cyrenian	ˌsaɪ.rɪˈniː.ən	si-re’-ne-an
Cyrenius	saɪˈriː.ni.əs	si-re’-ne-us
Cyrus	ˈsaɪ.rəs	si’-rus
Dabareh	ˈdæb.əˌrɛ	dab’-a-reh
Dabbasheth	ˈdæb.əˌʃɛθ	dab’-ba-sheth
Daberath	ˈdæb.əˌræθ	dab’-e-rath
Dabrasheth	ˈdæb.rəˌʃɛθ	dab’-ra-sheth
Dagon	ˈdeɪ.ɡɒn	da’-gon
Dalaiah	ˌdæl.əˈaɪ.ə	dal-a-i’-ah
Dalmanutha	dæl.məˈnuː.θə	dal-ma-nu’-thah
Dalmatia	dælˈmeɪ.ʃi.ə	dal-ma’-she-ah
Dalphon	ˈdæl.fɒn	dal’-fon
Damaris	ˈdæm.əˌrɪs	dam’-a-ris
Damascenes	ˌdæm.əˈsiːnɛs	dam-as-senes’
Damascus	dəˈmæs.kəs	da-mas’-cus
Dan	dæn	dan
Daniel	ˈdæn.jəl	dan’-yel
Danites	ˈdæn.aɪts	dan’-ites
Danjaan	ˈdæn.dʒɑːn	dan-ja’-an
Dannah	ˈdæn.ə	dan’-nah
Dara	ˈdɑː.rə	da’-rah
Darda	ˈdɑːr.də	dar’-dah
Darius	dəˈraɪ.əs	da-ri’-us
Darkon	ˈdɑːr.kɒn	dar’-kon
Dathan	ˈdeɪ.θən	da’-than
David	ˈdeɪ.vɪd	da’-vid
Debir	ˈdiː.bɪr	de’-bur
Deborah	ˈdɛb.ə.rə	deb’-o-rah
Decapolis	dɪˈkæp.əˌlɪs	de-cap’-o-lis
Dedan	ˈdiː.dæn	de’-dan
Dedanim	ˈdɛd.əˌnɪm	ded’-a-nim
Dehavites	dɛˈheɪ.vaɪts	de-ha’-vites
Dekar	ˈdiː.kɑːr	de’-kar
Delaiah	ˈdɛl.əˌaɪ.ə	del-a-i’-ah
Delilah	dɪˈlaɪ.lə	de-li’-lah
Demas	ˈdiː.mæs	de’-mas
Demetrius	dɪˈmiː.tri.əs	de-me’-tre-us
Derbe	ˈdɜːr.bi	der’-by
Deuel	ˈdiː.uː.ɛl	de-oo’-el
Deuteronomy	ˌduː.təˈrɒn.ə.mi	doot’-er-an’-e-me
Diamond	ˈdaɪ.mənd	dia’-mond
Diana	daɪˈæn.ə	di-an’-ah
Diblaim	ˈdɪb.leɪ.ɪm	dib’-la-im
Diblath	ˈdɪb.læθ	dib’-lath
Diblathaim	dɪbˈlæθ.aɪ.ɪm	dib-lath-a’-im
Dibon	ˈdaɪ.bɒn	di’-bon
Dibongad	ˈdaɪ.bɒnˌɡæd	di’-bon-gad’
Dibri	ˈdɪb.ri	dib’-ri
Didymus	ˈdɪd.ɪ.məs	did’-i-mus
Diklah	ˈdɪk.lɑː	dik’-lah
Dilean	ˈdɪl.i.ən	dil’-e-an
Dimnah	ˈdɪm.nə	dim’-nah
Dimon	ˈdaɪ.mɒn	di’-mon
Dimonah	daɪˈmɒn.ə	di-mon’-nah
Dinah	ˈdaɪ.nə	di’-na
Dinaites	ˈdaɪ.neɪ.ɪts	di’-na-ites
Dinhabah	ˈdɪn.hə.bɑː	din’-ha-bah
Dionysius	ˌdaɪ.əˈnɪʃ.i.əs	di-on-ish’-yus
Diotrephes	daɪˈɒt.rəˌfiːz	di-ot’-re-feez
Dishan	ˈdaɪ.ʃæn	di’-shan
Dishon	ˈdaɪ.ʃɒn	di’-shon
Dizahab	ˈdɪz.ə.hæb	diz’-a-hab
Dodai	ˈdoʊ.daɪ	do’-dahee
Dodanim	ˈdoʊ.də.nɪm	do’-da-nim
Dodavah	ˈdoʊ.də.vɑː	do’-da-vah
Dodo	ˈdoʊ.doʊ	do’-do
Doeg	ˈdoʊ.ɛɡ	do’-eg
Dophkah	ˈdɒf.kə	dof’-kah
Dor	dɔːr	dor
Dorcas	ˈdɔːr.kæs	dor’-cas
Dothan	ˈdoʊ.θæn	do’-than
Drusilla	druːˈsɪl.ə	dru-sil’-lah
Dumah	ˈduː.mɑː	doo’-mah
Dura	ˈduː.rə	doo’-rah
Easter	ˈiːs.tər	east’-er
Ebal	ˈiː.bæl	e’-bal
Ebed	ˈiː.bɛd	e’-bed
Ebedmelech	ˈiː.bɛdˈmɛ.lɛk	e’-bed-me’-lek
Ebenezer	ˈɛb.əˌniː.zər	eb-en-e’-zur
Eber	ˈiː.bər	e’-bur
Ebiasaph	ˈɛb.i.ə.sæf	e-bi’-a-saf
Ebronah	ˈɛb.roʊ.nə	eb-ro’-nah
Ecclesiastes	ɪˌkliːzɪˈæs.tiːz	e-kle’-ze-as’-tez
Ed	ɛd	ed
Edar	ˈiː.dɑːr	e’-dar
Eden	ˈiː.dən	e’-dun
Eder	ˈiː.dər	e’-dur
Edom	ˈiː.dəm	e’-dum
Edomites	ˈiː.dəˌmaɪts	e’-dum-ites
Edrei	ˈɛd.reɪ	ed’-re-i
Eglah	ˈɛɡ.lɑː	eg’-lah
Eglaim	ˈɛɡ.laɪ.ɪm	eg’-la-im
Eglon	ˈɛɡ.lɒn	eg’-lon
Egypt	ˈiː.dʒɪpt	e’-jipt
Egyptian	ɪˈdʒɪp.ʃən	e-jip’-shun
Ehi	ˈiː.haɪ	e’-hi
Ehud	ˈiː.hʌd	e’-hud
Eker	ˈiː.kər	e’-ker
Ekron	ˈɛk.rɒn	ec’-ron
Ekronites	ˈɛk.roʊˌnaɪts	ek’-ron-ites
Eladah	ˈɛl.ə.dɑː	el’-a-dah
Elah	ˈiː.lɑː	e’-lah
Elam	ˈiː.ləm	e’-lam
Elamites	ˈiː.ləˌmaɪts	e’-lam-ites
Elasah	ˈɛl.ə.sɑː	el’-a-sah
Elath	ˈiː.læθ	e’-lath
Elbethel	ˈɛlˈbɛθ.ɛl	el-beth’-el
Eldaah	ˈɛl.dɑː.ɑː	el’-da-ah
Eldad	ˈɛl.dæd	el’-dad
Elead	ˈɛl.i.æd	e’-le-ad
Elealeh	ˈɛl.i.əˌleɪ	el-e-a’-leh
Eleasah	ˈɛl.iˌə.sɑː	el-e’-a-sah
Eleazar	ˈɛl.iˌə.zɑːr	el-e-a’-zar
Elelohe	ˈɛl.ɛl.oʊˈheɪ	el-el-o’-he
Elelohe-Israel	ˈɛl.ɛl.oʊˈheɪ ˈɪz.reɪˌɛl	el-el-o’-he-iz’-rah-el
Eleph	ˈɛl.ɛf	e’-lef
Elhanan	ɛlˈhɑː.nən	el-ha’-nan
Eli	ˈiː.laɪ	e’-li
Eliab	ˈiː.li.æb	e’-le-ab
Eliada	ˌiː.laɪˈɑː.də	e-li’-a-dah
Eliadah	ˌiː.laɪˈɑː.də	e-li’-a-dah
Eliah	ˌiːˈlaɪ.ɑː	e-li’-ah
Eliahba	ˌiː.laɪˈɑː.bə	e-li’-ah-bah
Eliakim	ɛˈlaɪ.ə.kɪm	el-li’-a-kim
Eliam	ˈiː.li.æm	e’-le-am
Elias	iˈlaɪ.əs	e-li’-as
Eliasaph	iˈlaɪ.ə.sæf	e-li’-a-saf
Eliashib	iˈlaɪ.ə.ʃɪb	e-li’-a-shib
Eliathah	iˈlaɪ.ə.θɑː	e-li’-a-thah
Elidad	iˈlaɪ.dæd	e-li’-dad
Eliel	ˈiː.li.ɛl	e’-le-el
Elienai	ˌiː.liˈeɪ.naɪ	e-li-e’-nahee
Eliezer	ˌiː.liˈeɪ.zər	e-li-e’-zur
Elihoenai	ˌɛl.i.hoʊˈeɪ.naɪ	e-li-ho-e’-nahee
Elihoreph	ˌɛl.iˈhoʊ.rɛf	e-li-ho’-ref
Elihu	ˈiː.laɪ.huː	e-li’-hew
Elijah	ɪˈlaɪ.dʒə	e-li’-jah
Elika	iˈlaɪ.kə	e-li’-kah
Elim	ˈiː.lɪm	e’-lim
Elimelech	ɪˈlɪm.ɛ.lɛk	e-lim’-e-lek
Elioenai	ˌiː.liˈoʊ.ɛ.naɪ	e-li-o-e’-nahee
Eliphal	ˈɛl.ɪ.fæl	el’-i-fal
Eliphalet	ɛˈlɪf.ə.lɛt	e-lif’-a-let
Eliphaz	ˈɛl.ɪ.fæz	el’-if-az
Elipheleh	ɪˈlɪf.ə.leɪ	e-lef’-e-leh
Eliphelet	ɛˈlɪf.ə.lɛt	e-lif’-e-let
Elisabeth	ɪˈlɪz.ə.bɛθ	e-liz’-a-beth
Eliseus	ɛlˈɪs.juːs	el-i-se’-us
Elisha	ɪˈlaɪ.ʃə	e-li’-shah
Elishah	ɪˈlaɪ.ʃə	e-li’-shah
Elishama	ɛˈlɪʃ.ə.mə	e-lish’-a-mah
Elishaphat	ɛˈlɪʃ.ə.fæt	e-lish’-a-fat
Elisheba	ɛˈlɪʃ.ɪ.bə	e-lish’-e-bah
Elishua	ɛˈlɪʃ.uː.ɑː	e-lish’-oo-ah
Eliud	ˈiː.ljuːd	e-li’-ud
Elizaphan	ɪˈlɪz.ə.fæn	e-liz’-a-fan
Elizur	ˈɛl.ɪ.zʊr	e-li’-zur
Elkanah	ˈɛl.kə.nɑː	el-ka’-nah
Elkoshite	ˈɛl.koʊˌʃaɪt	el’-ko-shite
Ellasar	ˈɛl.lə.sɑːr	el’-la-sar
Elmodam	ɛlˈmoʊ.dæm	el-mo’-dam
Elnaam	ɛlˈnɑː.æm	el-na’-am
Elnathan	ɛlˈnɑː.θən	el-na’-than
Eloi	ɛˈloʊ.aɪ	e-lo’-ee
Elon	ˈiː.lɒn	e’-lon
Elonbethhanan	ˈiː.lɒnˌbɛθ.həˈnɑːn	e’-lon-beth-ha’-nan
Elonites	ˈiː.ləˌnaɪts	e’-lon-ites
Eloth	ˈiː.lɒθ	e’-loth
Elpaal	ˈɛl.pɑːl	el-pa’-al
Elpalet	ˈɛl.pə.lɛt	el-pa’-let
Elparan	ˈɛl.pə.ræn	el-pa’-ran
Eltekeh	ˈɛl.tɛ.kɛ	el’-te-keh
Eltekon	ˈɛl.tɛ.kɒn	el’-te-kon
Eltolad	ˈɛl.toʊ.læd	el-to’-lad
Elul	ˈiː.lʌl	e’-lul
Eluzai	ɛˈluː.zaɪ	e-loo’-zahee
Elymas	ˈɛl.ɪ.mæs	el’-i-mas
Elzabad	ˈɛl.zə.bæd	el’-za-bad
Elzaphan	ˈɛl.zə.fæn	el’-za-fan
Emerald	ˈɛm.ə.rəld	em’-er-ald
Emims	ˈiː.mɪmz	e’-mims
Emmanuel	ɪˈmæn.juː.ɛl	em-man’-uel
Emmaus	ˈɛm.ə.ʌs	em’-ma-us
Emmor	ˈɛm.ɔːr	em’-mor
Enam	ˈiː.næm	e’-nam
Enan	ˈiː.næn	e’-nan
Endor	ˈɛn.dɔːr	en’-dor
Eneas	ˈiː.niː.æs	e’-ne-as
Eneglaim	ɛnˈɛɡ.leɪ.ɪm	en-eg’-la-im
Engannim	ɛnˈɡæn.ɪm	en-gan’-nim
Engedi	ɛnˈɡɛ.di	en-ghe’-di
Enhaddah	ɛnˈhæd.ə	en-had’-dah
Enhakkore	ɛnˈhæk.koʊ.reɪ	en-hak’-ko-re
Enhazor	ɛnˈheɪ.zɔːr	en-ha’-zor
Enmishpat	ɛnˈmɪʃ.pæt	en-mish’-pat
Enoch	ˈiː.nɒk	e’-nok
Enos	ˈiː.noʊs	e’-nos
Enosh	ˈiː.nɒʃ	e’-nosh
Enrimmon	ɛnˈrɪm.ɒn	en-rim’-mon
Enrogel	ɛnˈroʊ.ɡɛl	en-ro’-ghel
Enshemesh	ɛnˈʃɛ.mɛʃ	en-she’-mesh
Entappuah	ɛnˈtæp.puː.ɑː	en-tap’-poo-ah
Epaenetus	ˌɛp.ɪˈnɛ.təs	ep-en’-e-tus
Epaphras	ˈɛp.ə.fræs	ep’-a-fras
Epaphroditus	ˌɛ.pæf.roʊˈdaɪ.təs	e-paf-ro-di’-tus
Epenetus	ɛpˈɛn.ɪ.təs	ep-en’-e-tus
Ephah	ˈiː.fɑː	e’-fah
Ephai	ˈiː.faɪ	e’-fahee
Epher	ˈiː.fər	e’-fur
Ephesdammim	ˈɛf.ɪsˈdæm.ɪm	e’-fes-dam’-min
Ephesians	ɪˈfiː.ʒənz	e-fe’-zheuns
Ephesus	ˈɛf.ɪ.səs	ef’-e-sus
Ephlal	ˈɛf.læl	ef’-lal
Ephod	ˈiː.fɒd	e’-fod
Ephphatha	ˈɛf.ə.θɑː	ef’-fath-ah
Ephraim	ˈiː.freɪ.ɪm	e’-fra-im
Ephraimites	ˈiː.freɪ.ɪˌmaɪts	e’-fra-im-ites
Ephrain	ˈiː.freɪn	e’-fra-in
Ephratah	ˈɛf.rə.tɑː	ef’-rat-ah
Ephrath	ˈiː.fræθ	e’-frath
Ephrathites	ˈɛf.rəˌθaɪts	ef’-rath-ites
Ephron	ˈiː.frɒn	e’-fron
Epicureans	ˌɛp.ɪˈkjʊr.iˌænz	ep-i-cu-re’-ans
Er	ɜːr	er
Eran	ˈiː.ræn	e’-ran
Eranites	ˈiː.rəˌnaɪts	e’-ran-ites
Erastus	ɪˈræs.təs	e-ras’-tus
Erech	ˈiː.rɛk	e’-rek
Eri	ˈiː.raɪ	e’-ri
Erites	ˈiː.raɪts	e’-rites
Esaias	ɛˈsaɪ.əs	e-sah’-yas
Esarhaddon	ˈɛ.sərˈhæd.ən	e’-zar-had’-dun
Esau	ˈiː.sɔː	e’-saw
Esek	ˈiː.sɛk	e’-sek
Eshbaal	ˈɛʃ.bɑːl	esh’-ba-al
Eshban	ˈɛʃ.bæn	esh’-ban
Eshcol	ˈɛʃ.kɒl	esh’-col
Eshean	ˈɛʃ.i.æn	esh’-e-an
Eshek	ˈɛʃ.ɛk	e’-shek
Eshkalonites	ˈɛʃ.kəˌloʊn.aɪts	esh’-ka-lon-ites
Eshtaol	ˈɛʃ.ta.ɒl	esh’-ta-ol
Eshtaulites	ˈɛʃ.taʊ.laɪts	esh’-ta-u-lites
Eshtemoa	ɛʃˈtɛm.oʊ.ɑː	esh-te-mo’-ah
Eshtemoh	ˈɛʃ.tɛ.moʊ	esh’-te-moh
Eshton	ˈɛʃ.tɒn	esh’-ton
Esli	ˈɛs.laɪ	es’-li
Esrom	ˈɛs.rɒm	es’-rom
Esther	ˈɛs.θər	es’-thur
Etam	ˈiː.tæm	e’-tam
Etham	ˈiː.θæm	e’-tham
Ethan	ˈiː.θæn	e’-than
Ethanim	ˈɛθ.ə.nɪm	eth’-a-nim
Ethbaal	ˈɛθ.bɑːl	eth’-ba-al
Ether	ˈiː.θər	e’-ther
Ethiopia	ˌiː.θiˈoʊ.pi.ə	e-the-o’-pe-ah
Ethiopian	ˌiː.θiˈoʊ.pi.ən	e-the-o’-pe-en
Ethnan	ˈɛθ.næn	eth’-nan
Ethni	ˈɛθ.naɪ	eth’-ni
Eubulus	ˈjuː.bjʊ.ləs	yu-bu’-lus
Eunice	ˈjuː.nɪ.si	yu-ni’-see
Euodias	juːˈoʊ.di.æs	yu-o’-de-as
Euphrates	juːˈfreɪ.tiːz	yu-fra’-teze
Euroclydon	ˌjuːˈrɒk.lɪ.dɒn	yu-roc’-lid-on
Eutychus	ˈjuː.tɪ.kəs	yu’-tik-us
Eve	iːv	eev
Evi	ˈiː.vaɪ	e’-vi
Evilmerodach	ˈiː.vɪlˈmɛr.oʊˌdæk	e’-vil-mer’-o-dak
Exodus	ˈɛk.soʊ.dʌs	ek’-so-dus
Ezar	ˈiː.zɑːr	e’-zar
Ezbai	ˈɛz.baɪ	ez’-bahee
Ezbon	ˈɛz.bɒn	ez’-bon
Ezekias	ˌɛz.ɪˈkaɪ.æs	ez-e-ki’-as
Ezekiel	ɪˈziː.ki.əl	e-zeke’-yel
Ezel	ˈiː.zɛl	e’-zel
Ezem	ˈiː.zɛm	e’-zem
Ezer	ˈiː.zər	e’-zur
Eziongaber	ˈiː.ziː.ɒnˌɡeɪ.bər	e’-ze-on-ga’-bur
Eziongeber	ˈiː.ziː.ɒnˈɡeɪ.bər	e’-ze-on-ge’-bur
Eznite	ˈɛz.naɪt	ez’-nite
Ezra	ˈɛz.rə	ez’-rah
Ezrahite	ˈɛz.rəˌhaɪt	ez’-rah-hite
Ezri	ˈɛz.raɪ	ez’-ri
Felix	ˈfiː.lɪks	fe’-lix
Festus	ˈfɛs.təs	fes’-tus
Fortunatus	fɔːrˈtjuː.nə.təs	for-chu-na’-tus
Frankincense	ˈfræŋk.ɪnˌsɛns	frank-in’-cense
Gaal	ɡɑːˈæl	ga’-al
Gaash	ɡɑːˈæʃ	ga’-ash
Gaba	ˈɡɑː.bə	ga’-bah
Gabbai	ˈɡæb.baɪ	gab’-bahee
Gabbatha	ˈɡæb.əˌθɑː	gab’-ba-thah
Gabriel	ˈɡeɪ.bri.əl	ga’-bre-el
Gad	ɡæd	gad
Gadarenes	ˌɡæd.əˈriːniːz	gad-a-renes’
Gaddi	ˈɡæd.i	gad’-di
Gaddiel	ˈɡæd.i.ɛl	gad’-de-el
Gadi	ˈɡɑː.daɪ	ga’-di
Gadites	ˈɡæd.aɪts	gad’-ites
Gaham	ˈɡɑː.hæm	ga’-ham
Gahar	ˈɡɑː.hɑːr	ga’-har
Gaius	ˈɡaɪ.əs	gah’-yus
Galal	ˈɡæl.æl	ga’-lal
Galatia	ɡælˈeɪ.ʃi.ə	ga-la’-she-ah
Galatians	ɡælˈeɪ.ʃənz	ga-la’-she-uns
Galeed	ˈɡæl.iːd	ga’-le-ed
Galilaean	ˌɡæl.ɪˈliː.ən	gal-i-le’-un
Galilee	ˈɡæl.ɪˌliː	gal’-i-lee
Gallim	ˈɡæl.ɪm	gal’-lim
Gallio	ˈɡæl.i.oʊ	gal’-le-o
Gamaliel	ɡəˈmeɪ.li.əl	gam-a’-le-el
Gammadims	ˈɡæm.əˌdɪmz	gam’-ma-dims
Gamul	ˈɡæm.jʊl	ga’-mul
Gareb	ˈɡæ.rɛb	ga’-reb
Garmite	ˈɡɑːr.maɪt	gar’-mite
Gashmu	ˈɡæʃ.muː	gash’-mu
Gatam	ˈɡæ.tæm	ga’-tam
Gath	ɡæθ	gath
Gathhepher	ˈɡæθˈhiː.fər	gath-he’-fer
Gathrimmon	ˈɡæθˌrɪm.ɒn	gath-rim’-mon
Gaza	ˈɡɑː.zə	ga’-zah
Gazathites	ˈɡɑː.zəˌθaɪts	ga’-zath-ites
Gazer	ˈɡeɪ.zər	ga’-zur
Gazez	ˈɡeɪ.zɛz	ga’-zez
Gazites	ˈɡɑː.zɪts	ga’-zites
Gazzam	ˈɡæz.æm	gaz’-zam
Geba	ˈɡɛ.bə	ghe’-bah
Gebal	ˈɡɛ.bəl	ghe’-bal
Geber	ˈɡɛ.bər	ghe’-bur
Gebim	ˈɡɛ.bɪm	ghe’-bim
Gedaliah	ɡɛd.əˈlaɪ.ə	ghed-a-li’-ah
Gedeon	ˈɡɛd.i.ɒn	ghed’-e-on
Geder	ˈɡɛ.dər	ghe’-dur
Gederah	ɡɛˈdɛ.rə	ghed’-e-rah
Gederathite	ɡɛdˈɛ.rəˌθaɪt	ghed’-e-rath-ite
Gederite	ˈɡɛd.ə.raɪt	ghed’-e-rite
Gederoth	ɡɛˈdɛ.roʊθ	ghed’-e-roth
Gederothaim	ɡɛd.ə.roʊˈθaɪ.ɪm	ghed-e-ro-tha’-im
Gedor	ˈɡɛ.dɔr	ghe’-dor
Gehazi	ɡɛˈhaɪ.zi	ghe-ha’-zi
Gehenna	ɡɪˈhɛn.ə	ge-hen’-na
Geliloth	ˈɡɛl.ɪˌloʊθ	ghel’-il-oth
Gemalli	ɡɛˈmæl.i	ghe-mal’-li
Gemariah	ɡɛm.əˈraɪ.ə	ghem-a-ri’-ah
Genesis	ˈdʒɛn.ə.sɪs	jen’-e-sis
Gennesaret	ˈɡɛn.ɪˌsær.ɛt	ghen-nes’-a-ret
Gentiles	ˈdʒɛn.taɪlz	jen’-tiles
Genubath	ˈɡɛn.juˌbæθ	ghen’-u-beth
Gera	ˈɡɛ.rə	ghe’-rah
Gerah	ˈɡɛ.rə	ghe’-rah
Gerar	ˈɡɛ.rɑr	ghe’-rar
Gergesenes	ˈɡɜr.dʒəˌsiːnɛz	ghur’-ghes-enes’
Gerizim	ˈɡɛr.ɪ.zɪm	gher’-iz-im
Gershom	ˈɡɜr.ʃɒm	ghur’-shom
Gershon	ˈɡɜr.ʃɒn	ghur’-shon
Gershonites	ˈɡɜr.ʃɒn.aɪts	ghur’-shon-ites
Gesham	ˈɡɛ.ʃæm	ghe’-sham
Geshem	ˈɡɛ.ʃɛm	ghe’-shem
Geshur	ˈɡɛ.ʃʊr	ghe’-shur
Geshuri	ɡɛˈʃʊr.i	ghesh’-u-ri
Geshurites	ɡɛˈʃʊr.aɪts	ghesh’-u-rites
Gether	ˈɡɛ.θər	ghe’-ther
Gethsemane	ˈɡɛθ.sɛm.əˌni	gheth-sem’-a-ne
Geuel	ˈɡɛ.uˌɛl	ghe-u’-el
Gezer	ˈɡɛ.zər	ghe’-zur
Gezrites	ˈɡɛz.raɪts	ghez’-rites
Giah	ˈɡaɪ.ə	ghi’-ah
Gibbar	ˈɡɪb.ɑr	ghib’-bar
Gibbethon	ˈɡɪb.ɪˌθɒn	ghib’-be-thon
Gibea	ˈɡɪb.i.ə	ghib’-e-ah
Gibeah	ˈɡɪb.i.ə	ghib’-e-ah
Gibeath	ˈɡɪb.iˌæθ	ghib’-e-ath
Gibeathite	ɡɪˈbɛ.əˌθaɪt	ghib’-e-ath-ite
Gibeon	ˈɡɪb.i.ɒn	ghib’-e-on
Gibeonites	ɡɪˈbɪ.ɒn.aɪts	ghib’-e-on-ites
Giblites	ˈɡɪb.laɪts	ghib’-lites
Giddalti	ɡɪˈdæl.ti	ghid-dal’-ti
Giddel	ˈɡɪd.əl	ghid’-del
Gideon	ˈɡɪd.i.ɒn	ghid’-e-on
Gideoni	ɡɪd.iˈoʊ.naɪ	ghid-e-o’-ni
Gidom	ˈɡaɪ.dɒm	ghi’-dom
Gihon	ˈɡaɪ.hɒn	ghi’-hon
Gilalai	ˈɡɪl.əˌlaɪ	ghil’-a-lahee
Gilboa	ɡɪlˈboʊ.ə	ghil-bo’-ah
Gilead	ˈɡɪl.iˌæd	ghil’-e-ad
Gileadites	ˈɡɪl.iˌæd.aɪts	ghil’-e-ad-ites
Gilgal	ˈɡɪl.ɡæl	ghil’-gal
Giloh	ˈɡaɪ.loʊ	ghi’-loh
Gilonite	ˈɡaɪ.loʊˌnaɪt	ghi’-lo-nite
Gimzo	ˈɡɪm.zoʊ	ghim’-zo
Ginath	ˈɡaɪ.næθ	ghi’-nath
Ginnetho	ˈɡɪn.nɛˌθoʊ	ghin’-ne-tho
Ginnethon	ˈɡɪn.nɛˌθɒn	ghin’-ne-thon
Girgashites	ˈɡɜr.ɡæ.ʃaɪts	ghur’-gash-ites
Girgasite	ˈɡɜr.ɡə.saɪt	ghur’-ga-site
Gispa	ˈɡɪs.pə	ghis’-pah
Gittahhepher	ˈɡɪt.əˌhiː.fər	ghit’-tah-he’-fer
Gittaim	ˈɡɪt.taɪm	ghit-ta’-im
Gittites	ˈɡɪt.aɪts	ghit’-tites
Gittith	ˈɡɪt.ɪθ	ghit’-tith
Gizonite	ˈɡaɪ.zoʊˌnaɪt	ghi’-zo-nite
Goath	ˈgoʊ.æθ	go’-ath
Gob	ɡɒb	gob
Gog	ɡɒɡ	gog
Golan	ˈɡoʊ.læn	go’-lan
Golgotha	ˈɡɒl.ɡəˌθɑː	gol’-go-thah
Goliath	ɡoʊˈlaɪ.æθ	go-li’-ath
Gomer	ˈɡoʊ.mər	go’-mer
Gomorrah	ɡəˈmɔːr.ə	go-mor’-rah
Gomorrha	ɡəˈmɔːr.ə	go-mor’-rah
Gopher	ˈɡoʊ.fər	go’-pher
Goshen	ˈɡoʊ.ʃən	go’-shen
Gozan	ˈɡoʊ.zæn	go’-zan
Grecia	ˈɡriː.ʃə	gre’-sha
Grecians	ˈɡriː.ʃənz	gre’-shuns
Greece	ɡriːs	gres
Greeks	ɡriːks	greks
Gudgodah	ˈɡʌd.ɡoʊˌdɑː	gud-go’-dah
Guni	ˈɡuː.naɪ	gu’-ni
Gunites	ˈɡuː.naɪts	gu’-nites
Gur	ɡʊr	gur
Gurbaal	ˈɡʊr.bɑːl	gur-ba’-al
Haahashtari	hɑː.əˈhæʃ.təˌraɪ	ha-a-hash’-te-ri
Habaiah	hæb.əˈjaɪ.ə	hab-ah’-yah
Habakkuk	ˈhæb.əˌkʊk	hab’-ak-kuk
Habaziniah	hæb.əz.ɪnˈaɪ.ə	hab-az-in-i’-ah
Habor	ˈheɪ.bɔːr	ha’-bor
Hachaliah	hæk.əˈlaɪ.ə	hak-a-li’-ah
Hachilah	ˈhæk.ɪˌlɑː	hak’i-lah
Hachmoni	ˈhæk.moʊ.naɪ	hak’-mo-ni
Hachmonite	ˈhæk.moʊˌnaɪt	hak’-mo-nite
Hadad	ˈhæ.dæd	ha’-dad
Hadadezer	hæd.əˈdiː.zər	had-a-de’-zer
Hadadrimmon	ˈhæ.dædˈrɪm.ɒn	ha’-dad- rim’-mon
Hadar	ˈhæ.dɑːr	ha’-dar
Hadarezer	hæd.əˈriː.zər	had-a-re’-zer
Hadashah	ˈhæd.əˌʃɑː	had’-a-shah
Hadassah	həˈdæs.ə	ha-das’-sah
Hadattah	həˈdæt.ə	ha-dat’tah
Hadid	ˈhæ.dɪd	ha’-did
Hadlai	ˈhæd.laɪ	had’-la-i
Hadoram	həˈdoʊ.ræm	ha-do’-ram
Hadrach	ˈhæ.dræk	ha’-drak
Hagab	ˈhæ.ɡæb	ha’-gab
Hagaba	ˈhæɡ.əˌbɑː	hag’-a-bah
Hagabah	ˈhæɡ.əˌbɑː	hag’-a-bah
Hagar	ˈheɪ.ɡɑːr	ha’-gar
Hagarenes	hæɡ.əˈriːniːz	hag-a-renes’
Hagarites	ˈhæɡ.əˌraɪts	hag’-a-rites
Hagerite	ˈhæɡ.ə.raɪt	hag’-e-rite
Haggai	ˈhæɡ.aɪ	hag’-ga-i
Haggeri	ˈhæɡ.ə.raɪ	hag’-gher-i
Haggi	ˈhæɡ.i	hag’-ghi
Haggiah	hæˈɡaɪ.ə	hag-ghi’-ah
Haggites	ˈhæɡ.aɪts	hag’-ghites
Haggith	ˈhæɡ.ɪθ	hag’-ghith
Hai	ˈhaɪ	ha’-i
Hakkatan	ˈhæk.əˌtæn	hak’-ka-tan
Hakkoz	ˈhæk.koʊz	hak’-koz
Hakupha	həˈkuː.fə	ha-ku’-fah
Halah	ˈheɪ.lɑː	ha’-lah
Halak	ˈheɪ.læk	ha’-lak
Halhul	ˈhæl.hʊl	hal’-hul
Hali	ˈheɪ.laɪ	ha’-li
Halleluiah	ˌhæl.ɛˈluː.jə	hal-le-loo’-i-yah
Hallelujah	ˌhæl.ɛˈluː.jə	hal-le-loo’-yah
Hallohesh	ˈhæl.oʊˌhɛʃ	hal-lo’-hesh
Halohesh	ˈhæl.oʊˌhɛʃ	hal-lo’-hesh
Ham	hæm	ham
Haman	ˈheɪ.mæn	ha’-man
Hamath	ˈheɪ.mæθ	ha’-math
Hamathite	ˈhæm.əˌθaɪt	ham’-a-thite
Hamathzobah	həˈmæθˈzoʊ.bə	ha’-math-zo’-bah
Hammath	ˈhæm.æθ	ham’-math
Hammedatha	hæmˈmɛd.əˌθɑː	ham-med’-a-thah
Hammelech	ˈhæm.məˌlɛk	ham’-me-lek
Hammoleketh	hæmˈmɒl.ɛˌkɛθ	ham-mol’-e-keth
Hammon	ˈhæm.ɒn	ham’-mon
Hammothdor	ˈhæm.ɒθˈdɔːr	ham’-moth-dor’
Hamonah	həˈmoʊ.nə	ha-mo’-nah
Hamongog	ˈhæ.mɒnˌɡɒɡ	ha’-mon-gog’
Hamor	ˈhæ.mɔːr	ha’-mor
Hamuel	ˈhæ.mjʊˌɛl	ha-mu’-el
Hamul	ˈhæ.mjʊl	ha’-mul
Hamulites	ˈhæ.mjʊˌlaɪts	ha’-mu-lites
Hamutal	ˈhæ.mjʊˌtæl	ha-mu’-tal
Hanameel	hæˈnæm.iˌɛl	ha-nam’-e-el
Hanan	ˈhæ.næn	ha’-nan
Hananeel	hæˈnæn.iˌɛl	ha-nan’-e-el
Hanani	hæˈnæ.naɪ	ha-na’-ni
Hananiah	ˌhæn.əˈnaɪ.ə	han-a-ni’-ah
Hanes	ˈhæ.niːs	ha’-nees
Haniel	ˈhæ.niˌɛl	ha’-ne-el
Hannah	ˈhæn.ə	han’-nah
Hannathon	ˈhæn.əˌθɒn	han’-na-thon
Hanniel	ˈhæn.iˌɛl	han’-ne-el
Hanoch	ˈhæ.nɒk	ha’-nok
Hanochites	ˈhæ.nɒˌkaɪts	ha’-nok-ites
Hanun	ˈhæ.nʊn	ha’-nun
Haphraim	ˈhæf.raɪm	haf-ra’-im
Hara	ˈhæ.rə	ha’-rah
Haradah	ˈhær.əˌdɑː	har’-a-dah
Haran	ˈhær.ən	ha’-ran
Hararite	ˈhær.əˌraɪt	har’-a-rite
Harbona	ˈhɑr.boʊˌnɑː	har-bo’-nah
Harbonah	ˈhɑr.boʊˌnɑː	har-bo’-nah
Hareph	ˈhæ.rɛf	ha’-ref
Hareth	ˈhæ.rɛθ	ha’-reth
Harhaiah	hɑrˈhaɪ.ə	har-ha-i’-ah
Harhas	ˈhɑr.hæs	har’-has
Harhur	ˈhɑr.hʊr	har’-hur
Harim	ˈhæ.rɪm	ha’-rim
Hariph	ˈhæ.rɪf	ha’-rif
Harnepher	ˈhɑrˈnɛ.fər	har-ne’-fur
Harod	ˈhæ.roʊd	ha’-rod
Harodite	ˈhæ.roʊˌdaɪt	ha’-ro-dite
Haroeh	hæˈroʊ.ɛ	ha-ro’-eh
Harorite	ˈhæ.roʊˌraɪt	ha’-ro-rite
Harosheth	ˈhær.əˌʃɛθ	har’-o-sheth
Harsha	ˈhɑr.ʃə	har’-shah
Harum	ˈhæ.rʊm	ha’-rum
Harumaph	ˈhær.ʊˌmæf	ha-ru’-maf
Haruphite	ˈhær.ʊˌfaɪt	ha’-ru-fite
Haruz	ˈhær.ʊz	ha’-ruz
Hasadiah	ˌhæs.əˈdaɪ.ə	has-a-di’-ah
Hasenuah	ˌhæs.ɛˈnuː.ə	has-e-nu’-ah
Hashabiah	ˌhæʃ.əˈbaɪ.ə	hash-a-bi’-ah
Hashabnah	ˈhæʃ.æbˌnɑː	hash-ab’-nah
Hashabniah	ˌhæʃ.æbˈnaɪ.ə	hash-ab-ni’-ah
Hashbadana	ˌhæʃ.bædˈɑː.nə	hash-bad’-a-nah
Hashem	ˈhæ.ʃɛm	ha’-shem
Hashmonah	hæʃˈmoʊ.nə	hash-mo’-nah
Hashub	ˈhæ.ʃʊb	ha’-shub
Hashubah	hæˈʃuː.bə	hash-u’-bah
Hashum	ˈhæ.ʃʊm	ha’-shum
Hashupha	hæˈʃuː.fə	hash-u’-fah
Hasrah	ˈhæs.rə	has’-rah
Hassenaah	ˈhæs.ɛˌnaɪ.ə	has-se-na’-ah
Hasshub	ˈhæʃ.ʌb	hash’-ub
Hasupha	həˈsʊf.ə	has-u’-fah
Hatach	ˈhæ.tæk	ha’-tak
Hathath	ˈhæ.θæθ	ha’-thath
Hatipha	ˈhæt.ɪ.fə	hat’-if-ah
Hatita	ˈhæt.ɪ.tə	hat’-it-ah
Hattil	ˈhæt.ɪl	hat’-til
Hattush	ˈhæt.ʊʃ	hat’-tush
Hauran	ˈhaʊ.ræn	hau’-ran
Havilah	ˈhæv.ɪ.lə	hav’-il-ah
Havothjair	ˈhæ.voʊθˈdʒaɪ.ər	ha’-voth-ja’-ir
Hazael	ˈhæz.ɑːˈɛl	ha’-za-el
Hazaiah	ˌhæz.əˈaɪ.ə	ha-za-i’-ah
Hazaraddar	ˈhæz.ərˈæd.ər	ha’-zar-ad’-dar
Hazarenan	ˈhæz.əˈrɛn.ən	ha’-zar-e’-nan
Hazargaddah	ˈhæz.ərˈɡæd.ə	ha’-zar-gad’-dah
Hazarhadatah	ˈhæz.ərˌhæd.əˈtɑː	ha’-zor-ha-dat’-tah
Hazarhatticon	ˈhæz.ərˈhæt.ɪˌkɒn	ha’-zar-hat’-ti-con
Hazarmaveth	ˈhæz.ərˈmæv.ɛθ	ha-zar-ma’-veth
Hazarshual	ˈhæz.ərˈʃuː.əl	ha’-zar-shoo’-al
Hazarsusah	ˈhæz.ərˈsuː.sə	ha’-zar-soo’-sah
Hazarsusim	ˈhæ.zərˈsuː.sɪm	ha’-zar-soo’-sim
Hazazontamar	ˈhæz.əˌzɒnˈtæ.mɑr	haz’-a-zon-ta’-mar
Hazelelponi	ˌhæz.ɛl.ɛlˈpoʊ.ni	haz-el-el-po’-ni
Hazerim	ˈhæz.ə.rɪm	haz’-e-rim
Hazeroth	ˈhæz.ə.roʊθ	haz’-e-roth
Hazezontamar	ˈhæz.əˌzɒnˈtæ.mɑr	haz’-e-zon-ta’-mar
Haziel	ˈhæ.zi.ɛl	ha’-ze-el
Hazo	ˈhæ.zoʊ	ha’-zo
Hazor	ˈhæ.zɔr	ha’-zor
Heber	ˈhiː.bər	he’-bur
Heberites	ˈhiː.bəˌraɪts	he’-bur-ites
Hebrews	ˈhiː.bruːz	he’-broos
Hebrewess	ˈhiː.bruːˌɛs	he’-broo-ess
Hebron	ˈhɛ.brən	he’-brun
Hebronites	ˈhɛ.brəˌnaɪts	he’-brun-ites
Hegai	ˈhɛ.ɡaɪ	he’-gahee
Hege	ˈhɛ.ɡeɪ	he’-ghe
Helah	ˈhiː.lə	he’-lah
Helam	ˈhiː.læm	he’-lam
Helbah	ˈhɛl.bɑː	hel’-bah
Helbon	ˈhɛl.bɒn	hel’-bon
Heldai	ˈhɛl.daɪ	hel’-dahee
Heleb	ˈhɛ.lɛb	he’-leb
Heled	ˈhɛ.lɛd	he’-led
Helek	ˈhɛ.lɛk	he’-lek
Helekites	ˈhɛ.lɛˌkaɪts	he’-lek-ites
Helem	ˈhɛ.lɛm	he’-lem
Heleph	ˈhɛ.lɛf	he’-lef
Helez	ˈhɛ.lɛz	le’-lez
Heli	ˈhiː.laɪ	he’-li
Helkai	ˈhɛl.kaɪ	hel’-kahee
Helkath	ˈhɛl.kæθ	hel’-kath
Helkathhazzurim	ˈhɛl.kæθˈhæz.jʊˌrɪm	hel’-kath-haz’-zu-rim
Helon	ˈhiː.lɒn	he’-lon
Hemam	ˈhiː.mæm	he’-mam
Heman	ˈhiː.mæn	he’-man
Hemath	ˈhiː.mæθ	he’-math
Hemdan	ˈhɛm.dæn	hem’-dan
Hen	hɛn	hen
Hena	ˈhiː.nə	he’-nah
Henadad	ˈhɛn.əˌdæd	hen’-a-dad
Henoch	ˈhiː.nɒk	he’-nok
Hepher	ˈhɛ.fər	he’-fer
Hepherites	ˈhɛ.fəˌraɪts	he’-fer-ites
Hephzibah	ˈhɛf.zɪˌbɑː	hef’-zi-bah
Heres	ˈhɛ.rɛs	he’-res
Heresh	ˈhɛ.rɛʃ	he’-resh
Hermas	ˈhɜr.mæs	her’-mas
Hermes	ˈhɜr.miːz	her’-mees
Hermogenes	hɜrˈmɒdʒ.əˌniːz	her-moj’-e-nees
Hermon	ˈhɜr.mɒn	her’-mon
Hermonites	ˈhɜr.məˌnaɪts	her’-mon-ites
Herod	ˈhɛr.ɒd	her’-od
Herodians	hɪˈroʊ.diˌænz	he-ro’-de-uns
Herodias	hɛˈroʊ.di.æs	he-ro’-de-as
Herodion	hɛˈroʊ.diˌɒn	he-ro’-de-on
Hesed	ˈhɛ.sɛd	he’-sed
Heshbon	ˈhɛʃ.bɒn	hesh’-bon
Heshmon	ˈhɛʃ.mɒn	hesh’-mon
Heth	hɛθ	heth
Hethlon	ˈhɛθ.lɒn	heth’-lon
Hezeki	ˈhɛz.ɛˌkaɪ	hez’-e-ki
Hezekiah	ˌhɛz.ɛˈkaɪ.ə	hez-e-ki’-ah
Hezion	ˈhɛz.iˌɒn	he’-zi-on
Hezir	ˈhɛz.ɪr	he’-zur
Hezrai	ˈhɛz.raɪ	hez’-rahee
Hezro	ˈhɛz.roʊ	hez’-ro
Hezron	ˈhɛz.rɒn	hez’-ron
Hezronites	ˈhɛz.rɒnˌaɪts	hez’-ron-ites
Hiddai	ˈhɪd.daɪ	hid’-dahee
Hiddekel	ˈhɪd.dɛ.kɛl	hid’-de-kel
Hiel	ˈhaɪ.ɛl	hi’-el
Hierapolis	ˌhaɪ.əˈræp.əˌlɪs	hi-e-rap’-o-lis
Higgaion	hɪˈɡaɪ.jɒn	hig-gah’-yon
Hilen	ˈhaɪ.lɛn	hi’-len
Hilkiah	hɪlˈkaɪ.ə	hil-ki’-ah
Hillel	ˈhɪl.ɛl	hil’-lel
Hinnom	ˈhɪn.ɒm	hin’-nom
Hirah	ˈhaɪ.rə	hi’-rah
Hiram	ˈhaɪ.rəm	hi’-ram
Hittite	ˈhɪ.taɪt	hit’-tite
Hittites	ˈhɪ.taɪts	hit’-tites
Hivites	ˈhaɪ.vaɪts	hi’-vites
Hizkiah	hɪzˈkaɪ.ə	hiz-ki’-ah
Hizkijah	hɪzˈkaɪ.dʒə	hiz-ki’-jah
Hobab	ˈhoʊ.bæb	ho’-bab
Hobah	ˈhoʊ.bə	ho’-bah
Hod	hɒd	hod
Hodaiah	hoʊˈdaɪ.ə	ho-da-i’-ah
Hodaviah	hoʊˌdæ.viˈə	ho-da-vi’-ah
Hodesh	ˈhoʊ.dɛʃ	ho’-desh
Hodevah	hoʊˈdɛ.və	ho-de’-vah
Hodiah	hoʊˈdaɪ.ə	ho-di’-ah
Hodijah	hoʊˈdaɪ.dʒə	ho-di’-jah
Hoglah	ˈhɒɡ.lə	hog’-lah
Hoham	ˈhoʊ.hæm	ho’-ham
Holon	ˈhoʊ.lɒn	ho’-lon
Homam	ˈhoʊ.mæm	ho’-mam
Hophni	ˈhɒf.naɪ	hof’-ni
Hophra	ˈhɒf.rə	hof’-rah
Hor	hɔr	hor
Horam	ˈhoʊ.ræm	ho’-ram
Horeb	ˈhoʊ.rɛb	ho’-reb
Horem	ˈhoʊ.rɛm	ho’-rem
Horhagidgad	ˌhɔrˌhæɡˈɪdˌɡæd	hor-hag-id’-gad
Hori	ˈhoʊ.raɪ	ho’-ri
Horims	ˈhoʊ.rɪmz	ho’-rims
Horites	ˈhoʊ.raɪts	ho’-rites
Hormah	ˈhɔr.mə	hor’-mah
Horonaim	ˌhɔr.oʊˈnaɪm	hor-o-na’-im
Horonite	ˈhɔr.oʊˌnaɪt	ho’-ron-ite
Hosah	ˈhoʊ.sə	ho’-sah
Hosanna	ˌhoʊˈzæn.ə	ho-zan’-nah
Hosea	hoʊˈsiː.ə	ho-se’-ah
Hoshaiah	hoʊˈʃaɪ.ə	ho-sha-i’-ah
Hoshama	hoʊˈʃæm.ə	ho-sha’-mah
Hoshea	hoʊˈʃiː.ə	ho-she’-ah
Hotham	ˈhoʊ.θæm	ho’-tham
Hothan	ˈhoʊ.θæn	ho’-than
Hothir	ˈhoʊ.θɪr	ho’-thur
Hukkok	ˈhʌk.kɒk	huk’-kok
Hukok	ˈhʌ.kɒk	hu’-kok
Hul	hʌl	hul
Huldah	ˈhʌl.də	hul’-dah
Humtah	ˈhʌm.tə	hum’-tah
Hupham	ˈhʌf.æm	hu’-fam
Huphamites	ˈhʌf.əˌmaɪts	hu’-fam-ites
Huppah	ˈhʌp.ə	hup’-pah
Huppim	ˈhʌp.ɪm	hup-pim
Hur	hɜr	hur
Hurai	ˈhʊ.raɪ	hu’-rahee
Huram	ˈhʊ.rəm	hu’-ram
Huri	ˈhʊ.raɪ	hu’-ri
Hushah	ˈhʊ.ʃə	hu’-shah
Hushai	ˈhʊ.ʃaɪ	hu’-shahee
Husham	ˈhʊ.ʃəm	hu’-sham
Hushathite	ˈhʊ.ʃəˌθaɪt	hu’-shath-ite
Hushim	ˈhʊ.ʃɪm	hu’-shim
Huz	hʌz	huz
Huzzab	ˈhʌz.æb	huz’-zab
Hymenaeus	ˌhaɪ.məˈniː.əs	hy-men-e’-us
Ibhar	ˈɪb.hɑr	ib’-har
Ibleam	ˈɪb.liː.æm	ib’-le-am
Ibneiah	ɪbˈniː.ə	ib-ne-i’-ah
Ibnijah	ɪbˈnaɪ.dʒə	ib-ni’-jah
Ibri	ˈɪb.raɪ	ib’-ri
Ibzan	ˈɪb.zæn	ib’-zan
Ichabod	ˈɪk.ə.bɒd	ik’-a-bod
Iconium	aɪˈkoʊ.niː.əm	i-co’-ne-um
Idalah	ˈɪd.ə.lə	id’-a-lah
Idbash	ˈɪd.bæʃ	id’-bash
Iddo	ˈɪd.doʊ	id’-do
Idumaea	ˌɪd.jʊˈmiː.ə	i-doo-me’-ah
Idumea	ɪˈdjuː.miː.ə	i-doo-me’-ah
Igal	ˈaɪ.ɡæl	i’-gal
Igdaliah	ɪgˌdælˈaɪ.ə	ig-da-li’-ah
Igeal	ˈɪg.iː.æl	ig’-e-al
Iim	ˈaɪ.ɪm	i’-im
Ijeabarim	ˈaɪ.dʒiˌæb.əˈrɪm	i’-je-ab’-a-rim
Ijon	ˈaɪ.dʒɒn	i’-jon
Ikkesh	ˈɪk.kɛʃ	ik’-kesh
Ilai	ˈaɪ.laɪ	i’-lahee
Illyricum	ɪˈlɪr.ɪ.kəm	il-lir’-ic-um
Imla	ˈɪm.lə	im’-lah
Imlah	ˈɪm.lə	im’-lah
Immanuel	ɪmˈmæn.juˌɛl	im-man’-u-el
Immer	ˈɪm.ər	im’-mur
Imna	ˈɪm.nə	im’-nah
Imnah	ˈɪm.nə	im’-nah
Imrah	ˈɪm.rə	im’-rah
Imri	ˈɪm.raɪ	im’-ri
India	ˈɪn.di.ə	in’-de-ah
Iphedeiah	ɪf.əˈdaɪ.ə	if-e-di’-ah
Iphtah El	ˈɪf.tɑ ɛl	NIV
Ir	ɜr	ur
Ira	ˈaɪ.rə	i’-rah
Irad:	ˈaɪ.ræd	i’-rad
Iram:	ˈaɪ.ræm	i’-ram
Iri:	ˈaɪ.raɪ	i’-ri
Irijah:	aɪˈraɪ.dʒə	i-ri’-jah
Irnahash:	ɜrˈnaɪ.hæʃ	ur-na’-hash
Iron:	ˈaɪ.rɒn	i’-ron
Irpeel:	ˈɜr.piː.ɛl	ur’-pe-el
Irshemesh:	ˈɜr.ʃɛ.mɛʃ	ur-she’-mesh
Iru:	ˈaɪ.ruː	i’-ru
Isaac:	ˈaɪ.zək	i’-za-ak
Isaiah:	aɪˈzeɪ.jə	i-za’-yah
Iscah:	ˈɪs.kə	is’-cah
Iscariot:	ɪsˈkær.iˌɒt	is-car’-e-ot
Ishbah:	ˈɪʃ.bɑː	ish’-bah
Ishbak:	ˈɪʃ.bæk	ish’-bak
Ishbibenob:	ˈɪʃ.biˌbɛˈnɒb	ish’-bi-be’-nob
Ishbosheth:	ˈɪʃ.boʊˌʃɛθ	ish-bo’-sheth
Ishi:	ˈaɪ.ʃaɪ	i’-shi
Ishiah:	ɪˈʃaɪ.ə	i-shi’-ah
Ishijah:	ɪˈʃaɪ.dʒə	i-shi’-jah
Ishma:	ˈɪʃ.mə	ish’-mah
Ishmael:	ˈɪʃ.meɪ.ɛl	ish’-ma-el
Ishmaelites:	ˈɪʃ.meɪ.əˌlaɪts	ish’-ma-el-ite
Ishmaiah:	ɪʃ.meɪˈaɪ.ə	ish-ma-i’-ah
Ishmeelites:	ˈɪʃ.miː.əˌlaɪts	ish’-me-el-ites
Ishmerai:	ˈɪʃ.məˌraɪ	ish’-me-rahee
Ishod:	ˈaɪ.ʃɒd	i’-shod
Ishpan:	ˈɪʃ.pæn	ish’-pan
Ishtob:	ˈɪʃ.tɒb	ish’-tob
Ishuah:	ˈɪʃ.uː.ə	ish’-u-ah
Ishuai:	ˈɪʃ.uˌaɪ	ish’-u-ahee
Ishui:	ˈɪʃ.uː.i	ish’-u-i
Ismachiah:	ɪsˈmæk.iˌə	is-ma-ki’-ah
Ismaiah:	ɪsˈmaɪ.ə	is-ma-i’-ah
Ispah:	ˈɪs.pɑː	is’-pah
Israel:	ˈɪz.ri.əl	iz’-ra-el
Israelites:	ˈɪz.ri.əˌlaɪts	iz’-ra-el-ites
Israelitish:	ˈɪz.ri.əˌlɪt.ɪʃ	iz’-ra-el-i-tish
Issachar:	ˈɪs.ə.kɑr	is’-sa-kar
Isshiah:	ˈɪʃ.aɪ.ə	is-shi’-ah
Isuah:	ˈɪs.uː.ə	is’-u-ah
Isui:	ˈɪs.uː.i	is’-u-i
Italian:	ɪˈtæl.jən	it-al’-yan
Italy:	ˈɪt.ə.li	it’-a-lee
Ithai:	ˈɪθ.aɪ	ith’-a-i
Ithamar:	ˈɪθ.ə.mɑr	ith’-a-mar
Ithiel:	ˈɪθ.iˌɛl	ith’-e-el
Ithmah:	ˈɪθ.mɑː	ith’-mah
Ithnan:	ˈɪθ.næn	ith’-nan
Ithra:	ˈɪθ.rə	ith’-rah
Ithran:	ˈɪθ.ræn	ith’-ran
Ithream:	ˈɪθ.riː.æm	ith’-re-am
Ithrite:	ˈɪθ.raɪt	ith’-rite
Ittahkazin:	ˈɪt.əˌkæˈzɪn	it’-tah-ka’-zin
Ittai:	ˈɪt.aɪ	it’-ta-i
Ituraea:	ɪˈtjʊə.riˌə	i-tu-re’-ah
Ivah:	ˈaɪ.və	i’-vah
Izehar:	ˈɪz.ɛ.hɑr	iz’-e-har
Izeharites:	ˈɪz.ɛ.hɑˌraɪts	iz’-e-har-ites
Izhar:	ˈɪz.hɑr	iz’-har
Izharites:	ˈɪz.hɑˌraɪts	iz’-har-ites
Izrahiah:	ɪzˈreɪ.əˌjaɪ.ə	iz-ra-hi’-ah
Izrahite:	ˈɪz.rəˌhaɪt	iz’-ra-hite
Izri:	ˈɪz.raɪ	iz’-ri
Jether:	ˈdʒɛ.θər	je’-thur
Jetheth:	ˈdʒɛ.θɛθ	je’-theth
Jethlah:	ˈdʒɛθ.lɑː	jeth’-lah
Jethro:	ˈdʒɛθ.roʊ	je’-thro
Jetur:	ˈdʒiː.tʊr	je’-tur
Jeuel:	ˈdʒuː.ɛl	je-u’-el
Jeush:	ˈdʒuːʃ	je’-ush
Jeuz:	ˈdʒuːz	je’-uz
Jew:	dʒuː	jew
Jewess:	ˈdʒuː.ɛs	jew’-ess
Jewish:	ˈdʒuː.ɪʃ	jew’-ish
Jewry:	ˈdʒuː.ri	jew’-ree
Jews:	dʒuːz	jews
Jezaniah:	ˌdʒɛz.əˈnaɪ.ə	jez-a-ni’-ah
Jezebel	ˈdʒɛz.ə.bɛl	jez’-e-bel
Jezer	ˈdʒiː.zər	je’-zur
Jezerites	ˈdʒiː.zər.aɪts	je’-zur-ites
Jeziah	dʒɛˈzaɪ.ə	je-zi’-ah
Jeziel	ˈdʒiː.zi.ɛl	je’-ze-el
Jezliah	ˈdʒɛz.li.ə	jez-li’-ah
Jezoar	ˈdʒɛz.oʊ.ɑr	je-zo’-ar
Jezrahiah	ˌdʒɛz.rəˈhaɪ.ə	jez-ra-hi’-ah
Jezreel	ˈdʒɛz.riːl	jez’-re-el
Jezreelite	ˈdʒɛz.riː.laɪt	jez’-re-el-ite
Jezreelitess	ˈdʒɛz.riː.lɪ.tɛs	jez’-re-el-i-tess
Jibsam	ˈdʒɪb.sæm	jib’-sam
Jidlaph	ˈdʒɪd.læf	jid’-laf
Jimna	ˈdʒɪm.nə	jim’-nah
Jimnah	ˈdʒɪm.nə	jim’-nah
Jimnites	ˈdʒɪm.naɪts	jim’-nites
Jiphtah	ˈdʒɪf.tə	jif’-tah
Jiphthahel	ˈdʒɪf.θəˌɛl	jif’-thah-el
Joab	ˈdʒoʊ.æb	jo’-ab
Joah	ˈdʒoʊ.ə	jo’-ah
Joahaz	ˈdʒoʊ.ə.hæz	jo’-a-haz
Joanna	dʒoʊˈæn.ə	jo-an’-nah
Joash	ˈdʒoʊ.æʃ	jo’-ash
Joatham	ˈdʒoʊ.ə.θæm	jo’-a-tham
Job	dʒoʊb	jobe
Jobab	ˈdʒoʊ.bæb	jo’-bab
Jochebed	ˈdʒɒk.ɪ.bɛd	jok’-e-bed
Joed	ˈdʒoʊ.ɛd	jo’-ed
Joel	ˈdʒoʊ.ɛl	jo’-el
Joelah	dʒoʊˈɛl.ə	jo-e’-lah
Joezer	dʒoʊˈɛz.ər	jo-e’-zer
Jogbehah	ˈdʒɒɡ.bi.hɑː	jog’-be-hah
Jogli	ˈdʒɒɡ.li	jog’-li
Joha	ˈdʒoʊ.hɑː	jo’-hah
Johanan	ˌdʒoʊˈhæn.ən	jo-ha’-nan
John	dʒɒn	jon
Joiada	dʒɔɪˈæd.ə	joy’-a-dah
Joiakim	dʒɔɪˈæ.kɪm	joy’-a-kim
Joiarib	dʒɔɪˈæ.rɪb	joy’-a-rib
Jokdeam	ˈdʒɒk.diː.æm	jok’-de-am
Jokim	ˈdʒoʊ.kɪm	jo’-kim
Jokmeam	ˈdʒɒk.miː.æm	jok’-me-am
Jokneam	ˈdʒɒk.niː.æm	jok’-ne-am
Jokshan	ˈdʒɒk.ʃæn	jok’-shan
Joktan	ˈdʒɒk.tæn	jok’-tan
Joktheel	ˈdʒɒk.θiː.ɛl	jok’-the-el
Jona	ˈdʒoʊ.nə	jo’-nah
Jonadab	ˈdʒɒn.əˌdæb	jon’-a-dab
Jonah	ˈdʒoʊ.nə	jo’-nah
Jonan	ˈdʒoʊ.næn	jo’-nan
Jonas	ˈdʒoʊ.næs	jo’-nas
Jonathan	ˈdʒɒn.ə.θən	jon’-a-than
Jonathelemrechokim	ˌdʒɒn.əˌθɛl.ɛmˌriːˈkoʊ.kɪm	jo’-nath-e’-lem-re-ko’-kim
Joppa	ˈdʒɒp.ə	jop’-pah
Jorah	ˈdʒoʊ.rə	jo’-rah
Jorai	ˈdʒoʊ.raɪ	jo’-rahee
Joram	ˈdʒoʊ.ræm	jo’-ram
Jordan	ˈdʒɔːr.dən	jor’-dan
Jorim	ˈdʒoʊ.rɪm	jo’-rim
Jorkoam	ˈdʒɔːr.koʊ.æm	jor’-ko-am
Josabad	ˈdʒoʊ.səˌbæd	jos’-a-bad
Josaphat	ˈdʒoʊ.səˌfæt	jos’-a-fat
Jose	ˈdʒoʊ.zeɪ	jo’-ze
Josedech	ˈdʒoʊ.sɪˌdɛk	jos’-e-dek
Joseph	ˈdʒoʊ.sɪf	jo’-zef
Joses	ˈdʒoʊ.sɛz	jo’-zez
Joshah	ˈdʒoʊ.ʃə	jo’-shah
Joshaphat	ˈdʒɒʃ.əˌfæt	josh’-a-fat
Joshaviah	ˌdʒoʊ.ʃəˈvaɪ.ə	josh-a-vi’-ah
Joshbekashah	ˌdʒoʊʃ.bɛˈkæʃ.ə	josh-bek’-a-shah
Joshua	ˈdʒɒʃ.uː.ə	josh’-u-ah
Josiah	dʒoʊˈsaɪ.ə	jo-si’-ah
Josias	dʒoʊˈsaɪ.æs	jo-si’-as
Josibiah	ˌdʒoʊ.sɪˈbaɪ.ə	jos-ib-i’-ah
Josiphiah	ˌdʒoʊ.sɪˈfaɪ.ə	jos-if-i’-ah
Jotbah	ˈdʒɒt.bɑː	jot’-bah
Jotbath	ˈdʒɒt.bæθ	jot’-bath
Jotbathah	ˈdʒɒt.bæˌθɑː	jot’-ba-thah
Jotham	ˈdʒoʊ.θəm	jo’-tham
Jozabad	ˈdʒoʊ.zəˌbæd	joz’-a-bad
Jozachar	ˈdʒoʊ.zəˌkɑr	joz’-a-kar
Jozadak	ˈdʒoʊ.zəˌdæk	joz’-a-dak
Jubal	ˈdʒuː.bəl	ju’-bal
Jubilee	ˈdʒuː.bɪˌliː	ju’-bi-lee
Jucal	ˈdʒuː.kəl	ju’-kal
Juda	ˈdʒuː.də	ju’-dah
Judaea	dʒuˈdiː.ə	ju-de’-ah
Judah	ˈdʒuː.də	ju’-dah
Judas	d͡ʒuːdəs	ju’-das
Judas Iscariot	d͡ʒuːdəs ɪsˈkɛɹiət	ju’-das Is-car’-e-ot
Jude	d͡ʒuːd	jood
Judea	d͡ʒuːˈdiːə	ju-de’-ah
Judith	d͡ʒuːdɪθ	ju’-dith
Julia	d͡ʒuːliə	ju’-le-ah
Julius	d͡ʒuːliəs	ju’-le-us
Junia	d͡ʒuːniə	ju’-ne-ah
Jupiter	d͡ʒuːpɪtər	ju’-pit-ur
Jushabhesed	d͡ʒuːʃəbˈhesed	ju’-shab-he’-sed
Justus	d͡ʒʌstəs	jus’-tus
Juttah	d͡ʒʌtə	jut’-tah
Kabzeel	kʰæbzɪl	kab’-ze-el
Kadesh	ˈkeɪdəʃ	ka’-desh
Kadeshbarnea	ˈkeɪdəʃˌbɑːrniːə	ka’-desh-bar’-ne-ah
Kadmiel	ˈkædmɪəl	kad’-me-el
Kadmonites	ˈkædmənˌaɪts	kad’-mo-nites
Kallai	ˈkælaɪ	kal’-la-i
Kanah	ˈkeɪnə	ka’-nah
Kareah	kəˈriːə	ka’-re-ah
Karkaa	ˈkɑːrkɑː	kar’-ka-ah
Karkor	ˈkɑːrkɔr	kar’-kor
Kartah	ˈkɑːrtə	kar’-tah
Kartan	ˈkɑːrtæn	kar’-tan
Kattath	ˈkætæθ	kat’-tath
Kedar	ˈkiːdɑr	ke’-dar
Kedemah	kəˈdiːmə	ked’-e-mah
Kedemoth	kəˈdiːməθ	ked’-e-moth
Kedesh	ˈkiːdəʃ	ke’-desh
Kedeshnaphtali	ˈkiːdəʃnæftəli	ke’-desh-naf’-ta-li
Kehelathah	kəhɛˈlætə	ke-hel’-a-thah
Keilah	kiːˈlə	ki’-lah
Kelaiah	kɛˈlaɪə	kel-ah’-yah
Kelita	kɛˈlaɪtə	kel’-i-tah
Kemuel	kɛˈmjuːəl	kem-u’-el
Kenan	ˈkiːnən	ke’-nan
Kenath	ˈkiːnæθ	ke’-nath
Kenaz	ˈkiːnæz	ke’-naz
Kenezite	ˈkɛnɪzaɪt	ken’-e-zite
Kenites	ˈkɛnaɪts	ken’-ites
Kenizzites	ˈkɛnɪzaɪts	ken’-iz-zites
Kerenhappuch	kəˈrɛnhæpək	ke’-ren-hap’-puk
Kerioth	ˈkiːrioθ	ke’-re-oth
Keros	ˈkiːros	ke’-ros
Keturah	kɛˈtʊəɹə	ket-u’-rah
Kezia	kəˈziːə	ke-zi’-ah
Keziz	ˈkiːzɪz	ke’-ziz
Kibzaim	kɪbzəˈʔim	kib-za’-im
Kidron	ˈkɪdrən	kid’-ron
Kinah	kiːˈnɑː	ki’-nah
Kir	kɪr	kur
Kirbrothhattaavah	kɪbrɵθˌhætːəˈæɪvə	kib’-roth-hat-ta’-a-vah
Kirharaseth	kʌrˈhɑːrəsɛθ	kur-har’-a-seth
Kirhareseth	kʌrˈhɑːrɛsɛθ	kur-har’-e-seth
Kirharesh	kʌrˈhɑːrɛʃ	kur-ha’-resh
Kirheres	kʌrˈhiːrəs	kur-he’-res
Kiriathaim	kɪriːəˈθeɪm	kir-e-a-thay’-im
Kirioth	ˈkiːrioθ	kir’-e-oth
Kirjath	ˈkɜːrjæθ	kur’-jath
Kirjathaim	ˈkɜːrjæθeɪm	kur’-jath-a’-im
Kirjatharba	ˈkɜːrjæθɑːrbə	kur’-jath-ar’-bah
Kirjatharim	ˈkɜːrjæθəˈrɪm	kur’-jath-a’-rim
Kirjathbaal	ˈkɜːrjæθbeɪl	kur’-jath-ba’-al
Kirjathhuzoth	ˈkɜːrjæθhjuːzɑθ	kur’-jath-hu’-zoth
Kirjathjearim	ˈkɜːrjæθˈd͡ʒɪərɪm	kur’-jath-je’-a-rim
Kirjathsannah	ˈkɜːrjæθˈsænə	kur’-jath-san’-nah
Kirjathsepher	kɜːrjæθˈseːfər	kur’-jath-se’-fer
Kish	kɪʃ	kish
Kishi	kɪʃi	kish’-i
Kishion	kɪʃiˈɔn	kish’-e-on
Kishon	kiʃɔn	ki’-shon
Kison	kiʃɔn	ki’-son
Kithlish	kɪθlɪʃ	kith’-lish
Kitron	kiːtrɔn	ki’-tron
Kittim	kɪtɪm	kit’-timm
Koa	koə	ko’-ah
Kohath	koʊhæθ	ko’-hath
Kohathites	koʊˈhæθaɪts	ko’-hath-ites
Kolaiah	koʊˈleɪə	ko-la-i’-ah
Korah	kɔːrə	ko’-rah
Korahite	kɔːˈraɪt	ko’-ra-hite
Korathites	kɔːˈraɪts	ko’-ra-thites
Kore	kɔːri	ko’-re
Korhites	kɔːrhaɪts	kor’-hites
Koz	kɔz	coz
Kushaiah	kuʃəˈjə	cu-shah’-yah
Laadah	laːʔadə	la’-a-dah
Laadan	laːdəˈn	la’-a-dan
Laban	ˈlɛbən	la’ban
Lachish	ˈlɛkiʃ	la’-kish
Lael	ˈleɪl	la’-el
Lahad	ˈlɛhæd	la’-had
Lahairoi	ləˈhɛɪɹoi	la-hah’-ee-roy
Lahmam	ˈlɛhməm	lah’mam
Lahmi	ˈlɛhmi	lah’mi
Laish	ˈleɪʃ	la’-ish
Lakum	ˈlɛkəm	la’-kum
Lama	ˈlɛmə	la’-mah
Lamech	ˈlɛmək	la’-mek
Laodicea	leɪoʊdɪˈsiːə	la-od-i-se’-ah
Laodiceans	leɪoʊdɪˈsiːənz	la-od-i-se’-uns
Lapidoth	ləˈpɪdəθ	lap’-i-doth
Lasea	ləˈsiːə	la-se’-ah
Lasha	ˈlɛʃə	la’-sha
Lasharon	ˈlɛʃərən	lash’-ar-on
Latin	ˈlætin	lat’-in
Lazarus	ˈlɛzərəs	laz’-a-rus
Leah	ˈliːə	le’-ah
Lebanah	ləˈbɛnə	leb’-a-nah
Lebanon	ˈlɛbənən	leb’-a-non
Lebaoth	ləˈbiːɔθ	leb’-a-oth
Lebbaeus	lɛbˈbiːəs	leb-be’-us
Lebonah	lɛˈboʊnə	le-bo’-nah
Lecah	ˈlɛkə	le’-cah
Lehabim	ləˈhɛbɪm	le’-ha-bim
Lehi	ˈlɛhi	le’-hi
Lemuel	ˈlɛmjuːəl	lem’-u-el
Leshem	ˈlɛʃəm	le’-shem
Letushim	ləˈtuːʃɪm	le-tu’-shim
Leummim	ləˈʔʊmɪm	le-um’-mim
Levi	ˈliːvaɪ	le’-vi
Leviathan	ləˈvaɪəθən	le-vi’-ath-un
Levités	ˈliːvaɪts	le’-vites
Libertines	ˈlɪbərtɪns	lib’-ur-tins
Libnah	ˈlɪbnə	lib’-nah
Libni	ˈlɪbni	lib’-ni
Libnites	ˈlɪbnɪts	lib’-nites
Libya	ˈlɪbiə	lib’-e-ah
Libyans	ˈlɪbiənz	lib’-e-uns
Likhi	ˈlɪki	lik’-hi
Linus	ˈlaɪnəs	li’-nus
Loammi	loʊˈʔæmi	lo-am’-mi
Lod	lɔd	lod
Lodebar	loʊˈdiːbɑr	lo-de’-bar
Lois	loɪs	lo’-is
Loruhamah	loʊruːhəˈmɛə	lo-ru-ha’-mah
Lot	lɔt	lot
Lotan	ˈlɔʊtən	lo’-tan
Lubims	ˈluːbɪmz	lu’-bim
Lucas	ˈluːkəs	lu’-cas
Lucifer	ˈluːsɪfər	lu’-sif-ur
Lucius	ˈluːʃiəs	lu’-she-us
Lud	lʌd	lud
Ludim	ˈluːdɪm	lu’-dim
Luhith	luːhɪθ	lu’-hith
Luke	luk	luke
Luz	lʌz	luz
Lycaonia	ˌlaɪkeɪˈoʊniə	li-ca-o’-ne-ah
Lycia	ˈlɪʃiə	lish’-e-ah
Lydda	ˈlɪdə	lid’-dah
Lydia	ˈlɪdiə	lid’-e-ah
Lydians	ˈlɪdiənz	lid’-e-uns
Lysanias	ˌlaɪsəˈniəs	li-sa’-ne-as
Lysias	ˈlɪsiəs	lis’-e-as
Lystra	ˈlɪstrə	lis’-trah
Maacah	maːʔɑːkə	ma’-a-kah) Same as Maacha
Maachah	maːʔɑːkə	ma’-a-kah
Maachathi	maːʔɑːkəθaɪt	ma-ak’-a-thite) Same as Maacha
Maachathites	maːʔɑːkəθaɪts	ma-ak’-a-thites
Maadai	maːʔɑːˈdaɪ	ma’-a-dahee
Maadiah	maːʔɑːdiˈə	ma-a-di’-ah
Maai	maːʔɑːˈiː	ma’-ahee
Maalehacrabbim	maːʔɑːleɪˈækræbɪm	ma’-a-leh-ac-rab’-bim
Maarath	maːʔɑːˈræθ	ma’-a-rath
Maaseiah	maːʔɑːziˈə	ma-a-si’-ah
Maasiai	maːʔɑːsiˈə	ma-a’-see-ahee) Same as Maaseia
Maath	maːʔɑːθ	ma’-ath
Maaz	maːz	ma’az
Maaziah	maːʔɑːziˈə	ma-a-zi’-ah
Macedonia	ˌmæsɪdoʊˈniə	mas-e-do’-nee-ah
Machbanai	makˈbænəi	mak’-ba-nahee
Machbenah	makˈbeɪnə	mak’-be-nah
Machi	ˈmaːki	ma’-ki
Machir	ˈmaːkɪr	ma’-kur
Machirites	maːˈkɪraɪts	ma’-kur-ites
Machnadebai	makˈnədeɪbaɪ	mak-nad’-e-bahee
Machpelah	makˈpeɪlə	mak-pe’-lah
Madai	maːʔɑːˈdaɪ	ma’-dahee
Madian	maːˈdiən	ma’-de-an
Madmannah	ˈmædmænə	mad-man’-nah
Madmenah	ˈmædmænə	mad-me’-nah
Madon	ˈmaːdən	ma’-don
Magbish	ˈmæɡbɪʃ	mag’-bish
Magdala	magˈdɑːlə	mag’-da-lah
Magdalene	magˈdælɪn	mag’-da-leen
Magdiel	magˈdiəl	mag’-de-el
Magog	ˈmaːɡɔɡ	ma’-gog
Magormissabib	maːˈɡɔrmɪsˈsæbɪb	ma’-gor-mis’-sa-bib
Magpiash	ˈmæɡpɪæʃ	mag’-pe-ash
Magus	ˈmeɪɡəs	mag’-us
Mahalah	maːʔɑːˈlɑː	ma’-ha-lah
Mahalaleel	məˈhæləleɪl	ma-hal’-a-le-el
Mahalath	maːʔɑːˈlɑːθ	ma’-ha-lath
Mahali	maːʔɑːˈli	ma’-ha-li
Mahanaim	maːhɑːˈnaɪm	ma-ha-na’-im
Mahaneh-dan	maːhɑːneɪˈdæn	ma’-ha-neh-dan
Maharai	maːhɑːˈraɪ	ma’-ha-rahee
Mahath	ˈmaːhæθ	ma’-hath
Mahavite	maːhɑːˈvaɪt	ma’-ha-vite
Mahazioth	maːhɑːziˈoʊθ	ma-ha’-ze-oth
Mahershalalhashbaz	maːhərˌʃæləˈlælhæʃbæz	ma’-her-sha’-lal-hash’-baz
Mahlah	maːʔɑːˈlɑː	mah’-lah
Mahli	maːʔɑːˈli	mah’-li
Mahlites	maːʔɑːˈlaɪts	mah’-lites
Mahlon	ˈmaːlən	mah’-lon
Mahol	ˈmaːhɔl	ma’-hol
Makaz	maːˈkæz	ma’-kaz
Makheloth	məˈkeɪlɔθ	mak’-he-loth
Makkedah	makˈkeɪdə	mak’-ke-dah
Maktesh	makˈteʃ	mak’-tesh
Malachi	məˈlæki	mal’-a-ki
Malcham	ˈmælkəm	mal’-kam
Malchiah	mælkiˈə	mal-ki’-ah
Malchiel	ˈmælkɪəl	mal’-ke-el
Malchielites	mælˈkɪəlˌaɪts	mal’-ke-el-ites
Malchijah	mælkiˈə	mal-ki’-jah
Malchiram	ˈmælkɪrəm	mal’-ki-ram
Malchishua	mælkiˈʃuːə	mal’-ki-shu’-ah
Malchus	ˈmælkəs	mal’-kus
Maleleel	məˈleleɪl	mal’-e-le-el
Mallothi	mælˈloʊθi	mal’-lo-thi
Malluch	ˈmælək	mal’-luk
Mammon	ˈmæmən	mam’-mon
Mamre	ˈmæmri	mam’-re
Manaen	məˈneɪən	man’-a-en
Manahath	məˈnɑːhæθ	man’-a-hath
Manahethites	məˈnɑːheθˌaɪts	man’-a-heth-ites
Manasseh	məˈnæsə	ma-nas’-seh
Manasses	məˈnæsˌsiːz	ma-nas’-seez
Manassites	məˈnæsˌsaɪts	ma-nas’-sites
Maneh	ˈmaːneɪ	ma’-neh
Manoah	məˈnoʊə	ma-no’-ah
Maoch	ˈmaʊk	ma’-ok
Maon	ˈmaʊən	ma’-on
Maonites	ˈmaʊənˌaɪts	ma’-on-ites
Mara	ˈmɛərə	ma’-rah
Marah	ˈmɛərə	ma’-rah
Maralah	məˈrɑːlə	mar’-a-lah
Maranatha	mɛərənˈɑːθə	mar-an-a’-thah
Marcus	ˈmɑːrkəs	mar’-cus
Maresha	məˈreɪʃə	mar’-e-shah
Mareshah	məˈreɪʃə	mar’-e-shah
Maroth	ˈmɛərəθ	ma’-roth
Marsena	marˈsiːnə	mar’-se-nah
Mars’ Hill	marzˈhɪl	marz-hill
Martha	ˈmɑːrθə	mar’-thah
Mary	ˈmɛəri	ma’-ry
Maschil	məˈskɪl	mas’-kil
Mash	mæʃ	mash
Mashal	məˈʃæl	ma’-shal
Masrekah	məˈsreɪkə	mas’-re-kah
Massa	ˈmæsə	mas’-sah
Massah	ˈmæsə	mas’-sah
Mathusala	məˈθjuːsələ	ma-thu’-sa-lah
Matred	məˈtred	ma’-tred
Matri	ˈmætri	ma’-tri
Mattan	ˈmætən	mat’-tan
Mattanah	məˈtænə	mat’-ta-nah
Mattaniah	mætəˈniːə	mat-ta-ni’-ah
Mattatha	məˈtæθə	mat’-ta-thah
Mattathah	məˈtæθə	mat’-ta-thah
Mattathias	mætəˈθiːəs	mat-ta-thi’-as
Mattenai	mætəˈneɪ	mat’-te-nahee
Matthan	ˈmæθən	mat’-than
Matthat	ˈmæθæt	mat’-that
Matthew	ˈmæθjuː	math’-ew
Matthias	ˈmæθiəs	mat’-thias
Mattithiah	mæt-tiθ-iˈah	mat-tith-i’-ah
Mazzaroth	ˈmæz-ə-rɔθ	maz’-za-roth
Meah	ˈmiːə	me’-ah
Mearah	ˈmiː-a-rah	me’-a-rah
Mebunnai	me-bʌnˈnai	me-bun’-nahee
Mecherathite	me-kəˈræθ-aɪt	me-ker’-ath-ite
Medad	ˈmiː-dad	me’-dad
Medan	ˈmiː-dan	me’-dan
Medes	miːdz	meed
Medeba	ˈmiː-de-bə	med’-e-bah
Media	ˈmiː-di-ə	me’-de-ah
Median	ˈmiː-di-ən	me’-de-an
Megiddo	me-ˈɡɪd-doʊ	me-ghid’-do
Megiddon	me-ˈɡɪd-dɔn	me-ghid’-don
Mehetabeel	me-ˈhɛt-ə-biːl	me-het’-a-be-el
Mehetabel	me-ˈhɛt-ə-bɛl	me-het’-a-bel
Mehida	ˈmiː-hi-də	me-hi’-dah
Mehir	ˈmiː-hʊr	me’-hur
Meholathite	me-ˈhɔ-ləθ-aɪt	me-ho’-lath-ite
Mehujael	me-ˈhuː-ja-el	me-hu’-ja-el
Mehuman	me-ˈhuː-mɑːn	me-hu’-man
Mehunims	me-ˈhuː-nɪmz	me-hu’-nims
Mejarkon	me-ˈdʒɑːr-kɔn	me-jar’-kon
Mekonah	me-ˈkoʊ-nə	me-ko’-nah
Melatiah	mel-ə-ˈti-ə	mel-a-ti’-ah
Melchi	ˈmel-ki	mel’-ki
Melchiah	ˈmel-ki-ə	mel-ki’-ah
Melchizedek	ˈmel-kis-ə-ˈdek	mel-kis’-e-dek
Melchishua	ˈmel-ki-ˈʃuːə	mel’-ki-shu’-ah
Melchizedek	ˈmel-kis-ə-ˈdek	mel-kiz’-e-dek
Melea	ˈmel-i-ə	mel’-e-ah
Melech	ˈmel-ek	me’-lek
Melicu	ˈmel-i-ku	mel’-i-cu
Melita	ˈmel-i-tə	mel’-i-tah
Melzar	ˈmel-zɑːr	mel’-zar
Memphis	ˈmem-fiːs	mem’-fis
Memucan	ˈmem-juː-kən	mem-u’-can
Menahem	men-ə-ˈhem	men’-a-hem
Menan	ˈmiː-nən	me’-nan
Mene	ˈmiː-ni	me’-ne
Meonenim	me-ˈoʊ-ni-nɪmz	me-on’-e-nim
Meonothai	me-ˈoʊ-no-ˈthaɪ	me-on’-o-thahee
Mephaath	ˈmɛf-ə-æθ	mef’-a-ath
Mephibosheth	ˈmɛf-i-ˈboʊ-ʃɛθ	me-fib’-o-sheth
Merab	ˈmiː-ræb	me’-rab
Meraiah	mer-ə-ˈi-ə	mer-a-i’-ah
Meriaoth	me-ˈraɪ-oʊθ	me-rah’-yoth
Merari	me-ˈraɪ-ri	me-ra’-ri
Merarites	me-ˈraɪ-rɪts	me-ra’-rites
Mereathaim	mer-ə-ˈthaɪ-əm	mer-a-tha’-im
Mercurius	mer-ˈkjuː-reɪ-əs	mer-cu’-re-us
Mered	ˈmiː-red	me’-red
Meremoth	ˈmɛr-ə-moth	mer’-e-moth
Meres	ˈmiː-res	me’-res
Meribah	ˈmer-i-bə	mer’-i-bah
Meribah Kadesh	ˈmer-i-bə ˈkeɪ-deʃ	mer’-i-bah ka’-desh
Meribbaal	me-ˈrɪb-ba-al	me-rib’-ba-al
Merodach	ˈmɛr-ə-dæk	mer’-o-dak
Merodachbaladan	ˈmɛr-ə-dæk-bæl-ə-ˈdan	mer’-o-dak-bal’-a-dan
Merom	ˈmiː-rəm	me’-rom
Meronothite	me-ˈron-ə-θaɪt	me-ron’-o-thite
Meroz	ˈmiː-roz	me’-roz
Mesech	ˈmiː-sek	me’-sek
Mesha	ˈmiː-ʃə	me’-shah
Meshach	ˈmiː-ʃæk	me’-shak
Meshech	ˈmiː-ʃek	me’-shek
Meshelemiah	me-ʃɛl-ə-ˈmiː-ə	me-shel-e-mi’-ah
Meshezabeel	me-ʃɛz-ə-ˈbiːl	me-shez’-a-be-el
Meshillemith	me-ʃɪl-ə-ˈmɪθ	me-shil’-le-mith
Meshillemoth	me-ʃɪl-ə-ˈmɒθ	me-shil’-le-moth
Meshobab	me-ˈʃoʊ-bab	me-sho’-bab
Meshullam	me-ˈʃʊl-əm	me-shul’-lam
Meshullemeth	me-ˈʃʊl-ə-mɛθ	me-shul’-le-meth
Mesobaite	me-ˈsoʊ-baɪt	me-so’-ba-ite
Mesopotamia	mes-o-pə-ˈteɪ-mi-ə	mes-o-po-ta’-me-ah
Messiah	mə-ˈsaɪ-ə	mes-si’-ah
Messias	mə-ˈsaɪ-əs	mes-si’-as
Methegammah	me-ˈθɛg-ə-ˈmɑː	me’-theg-am’-mah
Methusael	me-ˈθjuː-sə-ɛl	me-thu’-sa-el
Methuselah	me-ˈθjuː-sə-lə	me-thu’-se-lah
Meunim	miː-ˈuː-nɪm	me-u’-nim
Mezahab	ˈmɛz-ə-hæb	mez’-a-hab
Miamin	miː-ˈaɪ-mɪn	mi’-a-min
Mibhar	ˈmɪb-hɑːr	mib’-har
Mibsam	ˈmɪb-sæm	mib’-sam
Mibzar	ˈmɪb-zɑːr	mib’-zar
Micah	ˈmaɪ-kə	mi’-cah
Micaiah	maɪ-ke-ˈiː-ə	mi-ka-i’-ah
Micha	ˈmaɪ-kə	mi’-cah
Michael	ˈmaɪ-kəl	mi’-ka-el
Michah	ˈmaɪ-kə	mi’-cah
Micaiah	maɪ-ke-ˈiː-ə	mi-ka-i’-ah
Michal	ˈmɪk-əl	mi’-kal
Michmas	ˈmɪk-mæs	mik’-mas
Michmash	ˈmɪk-mæʃ	mik’-mash
Michmethah	ˈmɪk-me-θə	mik’-me-thah
Michri	ˈmɪk-ri	mik’-ri
Michtam	ˈmɪk-tæm	mik’-tam
Middin	ˈmɪd-dɪn	mid’-din
Midian	ˈmɪd-i-ən	mid’-e-an
Midianites	ˈmɪd-i-ən-aɪts	mid’-e-an-ites
Midianitish	ˈmɪd-i-ən-iː-tɪʃ	mid’-e-an-i’-tish
Migdalel	ˈmɪg-dal-el	mig’-dal-el
Migdalgad	ˈmɪg-dal-gad	mig’-dal-gad
Migdol	ˈmɪg-dɔl	mig’-dol
Migron	ˈmaɪ-grən	mi’-gron
Mijamin	mɪ-ˈdʒaɪ-mɪn	mij’-a-min
Mikloth	ˈmɪk-lɔθ	mik’-loth
Mikneiah	mɪk-ne-ˈiː-ə	mik-ne-i’-ah
Milalai	mɪl-ə-ˈlaɪ	mil’-a-lahee
Milcah	ˈmɪl-kə	mil’-cah
Milcom	ˈmɪl-kəm	mil’-com
Miletum	maɪ-ˈliː-təm	mi-le’-tum
Miletus	maɪ-ˈliː-təs	mi-le’-tus
Millo	ˈmɪl-loʊ	mil’-lo
Miniamin	mɪn-ə-ˈmɪn	min’-e-a-min
Minni	ˈmɪn-ni	min’-ni
Minnith	ˈmɪn-nɪθ	min’-nith
Miphkad	ˈmɪf-kæd	mif’-kad
Miriam	ˈmɪr-i-əm	mir’-e-am
Mirma	ˈmɜːr-mə	mur’-mah
Misgab	ˈmɪs-gæb	mis’-gab
Mishael	ˈmɪʃ-ə-ɛl	mish’-a-el
Mishal	ˈmi-ʃal	mi’-shal
Misham	ˈmi-ʃəm	mi’-sham
Misheal	ˈmɪʃ-iːl	mish’-e-al
Mishma	ˈmɪʃ-mə	mish’-mah
Mishmannah	ˈmɪʃ-mæn-ə	mish-man’-nah
Mishraites	ˈmɪʃ-raɪts	mish’-ra-ites
Mispar	ˈmɪs-pɑːr	mis’-par
Mispereth	mɪs-ˈpɛ-rɛθ	mis-pe’-reth
Misrephothmaim	mɪs-ˈrɛ-foʊθ-maɪm	mis’-re-foth-mah’-yim
Mithcah	ˈmɪθ-kə	mith’-cah
Mithnite	ˈmɪθ-naɪt	mith’-nite
Mithredath	ˈmɪθ-reɪ-dæθ	mith’-re-dath
Mitylene	mɪ-ti-ˈliː-neɪ	mit-i-le’-ne
Mizar	ˈmaɪ-zɑːr	mi’-zar
Mizpah	ˈmɪz-pə	miz’-pah
Mizpar	ˈmɪz-pɑːr	miz’-par
Mizpeh	ˈmɪz-pə	miz’-peh
Mizraim	mɪz’-raɪm	miz’-ra-im
Mizzah	ˈmɪz-zə	miz’-zah
Mnason	ˈneɪ-sən	na’-son
Moab	ˈmoʊ-æb	mo’-ab
Moabite	ˈmoʊ-æb-aɪt	mo’-ab-ite
Moabitess	ˈmoʊ-æb-i-tɛs	mo’-ab-i-tess
Moabitish	ˈmoʊ-æb-i-tɪʃ	mo’-ab-i-tish
Moadiah	moʊ-ə-ˈdiː-ə	mo-ad-i’-ah
Moladah	moʊ-ˈlɑː-də	mo-la’-dah
Molech	ˈmoʊ-lɛk	mo’-lek
Molid	ˈmoʊ-lɪd	mo’-lid
Moloch	ˈmoʊ-lɒk	mo’-loch
Morasthite	ˈmoʊ-ræs-thaɪt	mo’-ras-thite
Mordecai	mor-də-ˈkeɪ	mor’-de-cahee
Moreh	ˈmoʊ-reɪ	mo’-reh
Moreshethgath	ˈmoʊ-reɪ-ʃɛθ-gæt	mor’-e-sheth-gath
Moriah	moʊ-riː-ə	mo-ri’-ah
Mosera	moʊ-ˈsɛr-ə	mo-se’-rah
Moseroth	moʊ-ˈsɛr-ɒθ	mo-se’-roth
Moses	ˈmoʊ-zɛz	mo’-zez
Moza	ˈmoʊ-zə	mo’-zah
Mozah	ˈmoʊ-zə	mo’-zah
Muppim	ˈmʌp-pɪm	mup’-pim
Mushi	ˈmuː-ʃi	mu’-shi
Mushites	ˈmuː-ʃaɪts	mu’-shites
Muthlabben	mʌθ-ˈlæb-ən	muth-lab’-ben
Myra	ˈmaɪ-ra	mi’-rah
Mysia	ˈmɪʒ-i-ə	miz’ye-ah
Naam	naːm	na’-am
Naamah	naːˈmə	na’-a-mah
Naaman	naːˈmæn	na’-a-man
Naamathite	naːˈmænθaɪt	na’-a-math-ite
Naamites	naːˈmaɪts	na-’a-mites
Naarah	naːˈrə	na’-a-rah
Naarai	naːˈraɪ	na’-a-rahee
Naaran	naːˈræn	na’-a-ran
Naarath	naːˈræθ	na’-a-rath
Naashon	naːˈʃən	na’-a-shon
Naasson	naːˈsɑn	na’-as-son
Nabal	ˈnæbəl	na’-bal
Naboth	ˈneɪbɒθ	na’-both
Nachon	ˈneɪkən	na’-kon
Nachor	ˈneɪkɔr	na’-kor
Nadab	ˈneɪdæb	na’-dab
Nagge	ˈnægɪ	nag’-e
Nahalal	nəˈhæˡəl	na’-ha-lal
Nahaliel	nəˈhæliːl	na-ha’-le-el
Nahallal	nəˈhælləl	na’-hal-el
Nahalol	nəˈhæloʊl	na’-ha-lol
Naham	ˈneɪhæm	na’-ham
Nahamani	neɪhəmˈɑːni	na-ham’-a-ni
Naharai	neɪhəˈraɪ	na’-ha-rahee
Nahari	neɪˈhɑːri	na’-ha-ri
Nahash	ˈneɪhæʃ	na’-hash
Nahath	ˈneɪhæθ	na’-hath
Nahbi	ˈnɑːbi	nah’-bi
Nahor	ˈneɪhɔr	na’-hor
Nahshon	nɑːʃən	nah’-shon
Nahum	ˈneɪhəm	na’-hum
Nain	neɪn	nane
Naioth	neɪˈɒθ	nah’-yoth
Naomi	naːˈoʊmi	na’-o-mee
Naphish	ˈneɪfɪʃ	na’-fish
Naphtali	næfˈtɑːli	naf’-ta-li
Naphtuhim	næfˈtjuːhɪm	naf’-too-him
Narcissus	nɑːˈsɪsʌs	nar-sis’-sus
Nashon	nɑːʃən	na’-shon
Nathan	ˈneɪθæn	na’-than
Nathanael	nəˈθænːiːl	na-than’-a-el
Nathanmelech	neɪθənˈmeɪlɛk	na’-than-me’-lek
Naum	naːʊm	na’-um
Nazarene	næzəˈriːn	naz-a-reen’
Nazareth	ˈnæzəreθ	naz’-a-reth
Nazarites	ˈnæzəraɪts	naz’-a-rites
Neah	ˈniːə	ne’-ah
Neapolis	niːˈæpəlɪs	ne-ap’-o-lis
Neariah	niːəˈriːə	ne-a-ri’-ah
Nebai	neɪˈbaɪ	ne’-bahee
Nebaioth	nebəˈjaɪɒθ	ne-bah’-yoth
Nebajoth	nebəˈjaʊθ	ne-ba’-joth
Neballat	nebəˈlæt	ne-bal’-lat
Nebat	ˈneɪbæt	ne’-bat
Nebo	ˈneɪboʊ	ne’-bo
Nebuchadnezzar	nɛbjukʌdˈnɛzɑr	neb-u-kad-nez’-zar
Nebuchadrezzar	nɛbjukədˈrɛzɑr	neb-u-kad-rez’-zar
Nebushasban	nebjuˈʃæsbæn	neb-u-shas’-ban
Nebuzaradan	nɛbjukʌzəˈrædən	neb-u-zar’-a-dan
Necho	ˈneɪkoʊ	ne’-ko
Nechoh	ˈneɪkoʊ	ne’-ko
Nedabiah	nedəˈbiːə	ned-a-bi’-ah
Neginah	nɛgəˈnaː	neg’-i-nah
Neginoth	nɛgəˈnoʊθ	neg’-i-noth
Nego	ˈneɪgoʊ	ne’-go
Nehelamite	neˈhɛləmaɪt	ne-hel’-am-ite
Nehemiah	nəˈhiːmiə	ne-he-mi’-ah
Nehiloth	neˈhaɪloʊθ	ne’-hi-loth
Nehum	ˈneɪhəm	ne’-hum
Nehushta	neˈhʊʃtə	ne-hush’-tah
Nehushtan	neˈhʊʃtæn	ne-hush’-tan
Neiel	neɪˈiːl	ne-i’-el
Nekeb	ˈneɪkɛb	ne’-keb
Nekoda	neˈkoʊdə	ne-ko’-dah
Nemuel	neˈmjuːəl	ne-mu’-el
Nemuelites	neˈmjuːəl-aɪts	ne-mu’-el-ites
Nepheg	ˈneɪfɛg	ne’-feg
Nephish	ˈneɪfɪʃ	ne’-fish
Nephishesim	neˈfɪʃ-iːzɪm	ne-fish’-e-sim
Nephthalim	nefˈθɑːlɪm	nef’-tha-lim
Nephtoah	nefˈtoʊə	nef-to’-ah
Nephusim	neˈfjuːzɪm	ne-fu’-sim
Ner	nʌr	nur
Nereus	ˈniːriːəs	ne’-re-us
Nergal	ˈnʌrɡæl	nur’-gal
Nergalsharezer	ˈnʌrɡæl-ʃəˈreɪzər	nur’-gal-sha-re’-zur
Neri	ˈneːri	ne’-ri
Neriah	neˈriːə	ne-ri’-ah
Nero	ˈneɪroʊ	ne’-ro
Nethaneel	neˈθænːiːl	ne-than’-e-el
Nethaniah	nɛθəˈniːə	neth-a-ni’-ah
Nethinims	ˈnɛθɪnɪmz	neth’-in-ims
Netophah	neˈtoʊfə	ne-to’-fah
Netophathi	neˈtoʊfəthi	ne-to’-fa-thi
Netophathite	neˈtoʊfəthaɪt	ne-to’-fa-thite
Neziah	neˈziːə	ne-zi’-ah
Nezib	ˈneɪzɪb	ne’-zib
Nibhaz	ˈnɪbhæz	nib’-haz
Nibshan	ˈnɪbʃæn	nib’-shan
Nicanor	nɪˈkænɔr	ni-ca’-nor
Nicodemus	ˌnɪkəˈdiːməs	nic-o-de’-mus
Nicolaitanes	nɪkəˈlaɪtænɛz	nic-o-la’-i-tans
Nicolas	ˈnɪkələs	nic’-o-las
Nicopolis	ˌnɪkəˈpɒlɪs	ni-cop’-o-lis
Niger	ˈnaɪdʒər	ni’-jur
Nimrah	ˈnɪmrə	nim’-rah
Nimrim	ˈnɪmrɪm	nim’-rim
Nimrod	ˈnɪmrɒd	nim’-rod
Nimshi	ˈnɪmʃi	nim’-shi
Nineveh	ˈnɪnəvi	nin’-e-veh
Ninevites	ˈnɪnəvaɪts	nin’-e-vites
Nisan	ˈnɪsæn	ni’-san
Nisroch	ˈnɪsrak	nis’-rok
No	noʊ	no
Noadiah	noʊəˈdiːə	no-a-di’-ah
Noah	ˈnoʊə	no’-ah
Nob	nɒb	nob
Nobah	ˈnoʊbə	no’-bah
Nod	nɒd	nod
Nodab	ˈnoʊdæb	no’-dab
Noe	noʊ	no’-e
Nogah	ˈnoʊɡə	no’-gah
Nohah	ˈnoʊə	no’-hah
Non	nɑːn	non
Noph	nɒf	nof
Nophah	ˈnoʊfə	no’-fah
Nun	nʌn	nun
Nymphas	ˈnɪmfæs	nim’-fas
Obadiah	oʊbəˈdiːə	o-ba-di’-ah
Obal	ˈoʊbæl	o’-bal
Obed	ˈoʊbɛd	o’-bed
Obededom	oʊˈbɛdɛdɒm	o’-bed-e’-dom
Obil	ˈoʊbɪl	o’-bil
Oboth	ˈoʊbɒθ	o’-both
Ocran	ˈoʊkræn	o’-cran
Oded	ˈoʊdɛd	o’-ded
Og	ɒg	og
Ohad	ˈoʊhæd	o’-had
Ohel	ˈoʊhɛl	o’-hel
Olivet	ˈɒlɪvɛt	ol’-i-vet
Olympas	oʊˈlɪmpæs	o-lim’-pas
Omar	ˈoʊmɑːr	o’-mar
Omega	oʊˈmeɪɡə	o’-me-gah
Omri	ˈɒmri	om’-ri
On	ɒn	on
Onam	ˈoʊnəm	o’-nam
Onan	ˈoʊnæn	o’-nan
Onesimus	oʊˈnɛsɪməs	o-nes’-i-mus
Onesiphorus	oʊnəˈsɪfərəs	o-ne-sif’-o-rus
Ono	ˈoʊnoʊ	o’-no
Onycha	oʊˈnɪkə	o-ny’-cha
Onyx	ˈoʊnɪks	o’-nyx
Ophel	ˈoʊfɛl	o’-fel
Ophir	ˈoʊfər	o’-fur
Ophni	ˈɒfni	of’-ni
Ophrah	ˈɒfrə	of’-rah
Oreb	ˈoʊrɛb	o’-reb
Oren	ˈoʊrɛn	o’-ren
Orion	oʊˈraɪən	o-ri’-on
Ornan	ˈɔːrnæn	or’-nan
Orpah	ˈɔːrpə	or’-pah
Osee	ˈoʊsiː	o’-see
Oshea	oʊˈʃiːə	o-she’-ah
Othni	ˈɒθni	oth’ni
Othniel	ˈɒθniːl	oth’-ne-el
Ozem	ˈoʊzɛm	o’-zem
Ozias	oʊˈziːəs	o-zi’-as
Ozni	ˈɒzni	oz’-ni
Ozmites	ˈɒznaɪts	oz’-nites
Paarai	paːˈəraɪ	pa’-ar-ahee
Pacatiana	paːkəʃiːˈænə	pa-ca-she-a’-nah
Padan	ˈpædæn	pa’-dan
Padanaram	ˈpædænəræm	pa’-dan-a’-ram
Padon	ˈpædən	pa’-don
Pagiel	ˈpægiːəl	pa’-ghe-el
Pahathmoab	ˈpæhæθˌmoʊæb	pa’-hath-mo’-ab
Pai	paɪ	pa’-i
Palal	ˈpælæl	pa’-lal
Palestina	pælɪˈstiːnə	pal-es-ti’-nah
Palestine	ˈpælɪstīn	pal’-es-tine
Pallu	ˈpælu	pal’-lu
Palluites	ˈpæljuːaɪts	pal’-lu-ites
Palti	ˈpælti	pal’-ti
Paltiel	ˈpælteːl	pal’-te-el
Paltite	ˈpæltaɪt	pal’-tite
Pamphylia	pæmˈfɪliə	pam-fil’-e-ah
Pannag	ˈpænæg	pan’-nag
Paphos	ˈpeɪfɒs	pa’-fos
Parah	ˈpærə	pa’-rah
Paran	ˈpæræn	pa’-ran
Parbar	ˈpɑːrˌbɑːr	par’-bar
Parmashta	pɑːrˈmæʃtə	par-mash’-tah
Parmenas	pɑːrˈmiːnæs	par’-me-nas
Parnach	ˈpɑːrnæk	par’-nak
Parosh	ˈpærɒʃ	pa’-rosh
Parshandatha	pɑːrˈʃænˌdæθə	par-shan’-da-thah
Parthians	ˈpɑːrθiənz	par-the’-uns
Paruah	pɑːrˈuːə	par’-u-ah
Parvaim	pɑːrˈvaɪm	par-va’-im
Pasach	ˈpeɪsæk	pa’-sak
Pasdammim	pæsˈdæmɪm	pas-dam’-mim
Paseah	pəˈseɪə	pa-se’-ah
Pashur	ˈpæʃər	pash’-ur
Patara	pəˈtærə	pat’-a-rah
Pathros	ˈpæθrɒs	path’-ros
Pathrusim	pæθˈruːsɪm	path-ru’-sim
Patmos	ˈpætmɒs	pat’-mos
Patrobas	pəˈtroʊbæs	pat’-ro-bas
Pau	paʊ	pa’-u
Paul	pɔːl	pawl
Paulus	ˈpɔːlʌs	pawl-us
Pedahel	ˈpɛdəhɛl	ped’-a-hel
Pedahzur	ˈpɛdəhˌzɜːr	ped’-a-hel
Pedaiah	pəˈdaɪə	pe-dah’-yah
Pekah	ˈpiːkə	pe’-kah
Pekahiah	piːkəˈhaɪə	pe-ka-hi’-ah
Pekod	ˈpiːkɒd	pe’-kod
Pelaiah	pɛˈlaɪə	pel-a-i’-ah
Pelaliah	pɛˈleɪliə	pel-a-li’-ah
Pelatiah	pɛˈleɪtiə	pel-a-ti’-ah
Peleg	ˈpiːlɛg	pe’-leg
Pelet	ˈpiːlɛt	pe’-let
Peleth	ˈpiːlɛθ	pe’-leth
Pelethites	pɛˈlɛthaɪts	pel’-e-thites
Pelonite	ˈpɛlənaɪt	pel’-o-nite
Peniel	pəˈniːl	pe-ni’-el
Peninnah	pəˈnɪnə	pe-nin’-nah
Pentecost	ˈpɛntekɒst	pen’-te-cost
Penuel	pəˈnuːəl	pe-nu’-el
Peor	ˈpiːɔr	pe’-or
Perazim	pɛˈræzɪm	per’-a-zim
Peres	ˈpiːrɛs	pe’-res
Peresh	ˈpiːrɛʃ	pe’-resh
Perez	ˈpiːrɛz	pe’-rez
Perezuzza	pɛrəˈzuːzə	pe’-rez-uz’-zah
Perezuzzah	pɛrəˈzuːzə	pe’-rez-uz’-zah
Perga	ˈpɜːrgə	pur’-gah
Pergamos	pɜːrˈgæmɒs	pur’-ga-mos
Perida	pɛrˈiːdə	per-i’-dah
Perizzites	pɛrˈɪzˌzaɪts	per’-iz-zite
Persia	ˈpɜːrʃə	per’-she-ah
Persians	ˈpɜːrʃənz	per’-she-un
Persis	ˈpɜːrsɪs	pur’-sis
Peruda	pɛrˈuːdə	per’-u-dah
Peter	ˈpiːtər	pe’-tur
Pethahiah	pɛθəˈhaɪə	peth-a-hi’-ah
Pethor	ˈpiːθɔr	pe’-thor
Pethuel	pəˈθjuːəl	pe-thu’-el
Peulthai	pəˈlθaɪ	pe-ul’-thahee
Phalec	ˈfeɪlɛk	fa’-lek
Phallu	ˈfælːu	fal’-lu
Phalti	ˈfælti	fal’-ti
Phaltiel	ˈfæltiːl	fal’-te-el
Phanuel	ˈfænjuːəl	fan-u’-el
Pharaoh	ˈfeɪroʊ	fa’-ra-o
Pharaohhophra	ˈfeɪroʊˌhɒfrə	fa’-ra-o-hof’-rah
Pharaohnecho	ˈfeɪroʊˌneɪkoʊ	fa’-ra-o-ne’-ko
Pharaohnechoh	ˈfeɪroʊˌneɪkoʊ	fa’-ra-o-ne’-ko
Phares	ˈfɛərɪz	fa’-rez
Pharez	ˈfɛərɪz	fa’-rez
Pharisees	ˈfærɪsiːz	far’-i-see
Pharosh	ˈfɛərɒʃ	fa’-rosh
Pharpar	ˈfɑːrpɑːr	far’-par
Pharzites	ˈfɑːrzaɪts	far’-zites
Phaseah	fəˈseɪə	fa-se’-ah
Phebe	ˈfiːbi	fe’-be
Phenice	ˈfiːniːsi	fe-ni’-se
Phenicia	fiːˈnɪʃɪə	fe-nish’-e-ah
Phichol	ˈfaɪkɒl	fi’-kol
Philadelphia	fɪlˌædɛlˈfiːə	fil-a-del’-fe-ah
Philemon	fɪˈliːmən	fi-le’-mon
Philetus	fɪˈliːtəs	fe-le’-tus
Philip	ˈfɪlɪp	fil’-ip
Philippi	fɪˈlɪpi	fil-ip’-pi
Philippians	fɪˈlɪpiənz	fil-ip’-pe-uns
Philistia	fɪlˈɪstiə	fil-is’-te-ah
Philistim	fɪˈlɪstɪm	fil-is’-tim
Philistines	fɪˈlɪstinz	fil-is’-tin
Philologus	fɪˈlɒlɒgəs	fil-ol’-o-gus
Phinehas	fɪˈniːhæs	fin’-e-has
Phlegon	ˈflɛgɒn	fle’-gon
Phrygia	ˈfrɪdʒiə	frij’-e-ah
Phurah	ˈfuːrə	fu’-rah
Phut	fʌt	fut
Phuvah	ˈfuːvə	fu’-vah
Phygellus	faɪˈdʒɛləs	fi-jel’-lus
Pibeseth	ˈpaɪbɪˈzɛθ	pi-be’-zeth
Pihahiroth	paɪhəˈhaɪrɒθ	pi-ha-hi’-roth
Pilate	ˈpaɪlət	pi’-lut
Pildash	ˈpɪldæʃ	pil’-dash
Pileha	pɪˈleɪə	pil’-e-hah
Piltai	pɪlˈtaɪ	pil’-tahee
Pinon	ˈpaɪnɒn	pi’-non
Piram	ˈpaɪræm	pi’-ram
Pirathon	pɪrˈæθən	pir’-a-thon
Pirathonite	pɪrˈæθənˌaɪt	pir’-a-thon-ite
Pisgah	ˈpɪzgə	piz’-gah
Pisidia	pɪˈsɪdiə	pi-sid’-e-ah
Pison	ˈpaɪsən	pi’-son
Pispah	ˈpɪzpə	piz’-pah
Pithom	ˈpaɪθɒm	pi’-thom
Pithon	ˈpaɪθən	pi’-thon
Pleiades	ˈpliːədəz	ple’ya-dez
Pochereth	poʊˈkɛrɛθ	po-ke’-reth
Pollux	ˈpɒlʌks	pol’-lux
Pontius	ˈpɒnʃiəs	pon’-she-us
Pontus	ˈpɒntəs	pon’-tus
Poratha	pɔrˈæθə	por’-a-thah
Potiphar	ˈpɒtɪfɑːr	pot’i-far
Potipherah	poʊtɪˈfɛərə	po-tif’e-rah
Praetorium	priːˈtɔːriəm	prae-to’-ri-um
Prisca	ˈprɪskə	pris’-cah
Priscilla	prɪˈsɪlə	pris-sil’-lah
Prochorus	proʊˈkɒrəs	prok’-o-rus
Ptolemais	tɒlɪˈmeɪɪs	tol-e-ma’-is
Pua	ˈpuːə	pu’ah
Puah	ˈpuːə	pu’-ah
Publius	ˈpʌbliəs	pub’-le-us
Pudens	ˈpjuːdɛnz	pu’-denz
Puhites	ˈpuːhaɪts	pu’-hites
Pul	pʌl	pul
Punites	ˈpuːnaɪts	pu’-nites
Punon	ˈpuːnɒn	pu’-non
Pur	pɜːr	pur
Purim	ˈpuːrɪm	pu’-rim
Put	pʌt	put
Puteoli	puːˈteɪoʊli	pu-te’-o-li
Putiel	ˈpuːtiəl	pu’-te-el
Pyrrhus	ˈpɪrəs	pir’-es
Quartus	ˈkwɔrtəs	quar’-tus
Raamah	raːˈəmə	ra’-a-mah
Raamiah	raːˈəmiːə	ra-a-mi’-ah
Raamses	raːˈæmzɛz	ra-am’-seze
Rabbah	ˈræbə	rab’-bah
Rabbath	ˈræbəθ	rab’-bath
Rabbi	ˈræbaɪ	rab’-bi
Rabbith	ˈræbɪθ	rab’-bith
Rabboni	ræˈboʊni	rab-bo-’ni
Rabmag	ˈræbmæg	rab’-mag
Rabsaris	ræbˈsærɪs	rab’-sa-ris
Rabshakeh	ræbˈʃeɪkə	rab’-sha-keh
Raca	ˈreɪkə	ra’-cah
Rachab	ˈreɪkæb	ra’-kab
Rachal	ˈreɪkəl	ra’-kal
Rachel	ˈreɪtʃəl	ra’-chel
Raddai	ræˈdaɪ	rad’-dahee
Ragau	ˈreɪɡɔː	ra’-gaw
Raguel	ˈreɪɡjuːəl	ra-gu’-el
Rahab	ˈreɪhæb	ra’-hab
Raham	ˈreɪhæm	ra’-ham
Rahel	ˈreɪhɛl	ra’-hel
Rakem	ˈreɪkɛm	ra’-kem
Rakkath	ˈræhkæθ	rah’-kath
Rakkon	ˈrækkɒn	rak’-kon
Ram	ræm	ram
Rama	ˈreɪmə	ra’-mah
Ramah	ˈreɪmə	ra’-mah
Ramath	ˈreɪməθ	ra’-math
Ramathaim	ræmˈəθaɪm	ram-a-tha’-im
Ramathaimzophim	ræmˈəθaɪmˌzoʊfɪm	ram-a-tha’-im-zo’-fim
Ramathite	ˈræməthaɪt	ra’-math-ite
Ramathlehi	ˈræməθˌlɛhi	ra’-math-le’-hi
Ramathmizpeh	ˈræməθˌmɪzpeː	ra’-math-miz’peh
Rameses	ˈræmɛsəz	ram’-e-seze
Ramiah	raːˈmiːə	ra-mi’-ah
Ramoth	ˈreɪməθ	ra’-moth
Ramothgilead	ˈreɪməθˌɡɪliːæd	ra’-moth-ghil’-e-ad
Rapha	ˈreɪfə	ra’-fah
Raphu	ˈreɪfu	ra’-fu
Reaia	riːˈəjə	re-ah’-yah
Reaiah	riːˈəjə	re-ah’yah
Reba	riːˈbə	Re’-bah
Rebecca	rɪˈbɛkə	re-bek’-kah
Rebekah	rɪˈbɛkə	re-bek’-kah
Recah	ˈriːkə	re’-kah
Rechab	ˈriːkæb	re’-kab
Rechabites	rɪˈkæbˌaɪts	rek’-ab-ites
Rechah	reɪˈkɔː	ray-kaw’
Red (Sea)	red (siː)	Sea
Reelaiah	riːˈɛlˌəjə	re-el-ah’-yah
Regem	ˈriːdʒɛm	re’-ghem
Regemmelech	ˈriːdʒɛmˌmɛlɛk	re’-ghem-me’-lek
Rehabiah	riːhæbˈiːə	re-hab-i’-ah
Rehob	ˈriːhɒb	re’-hob
Rehoboam	riːhoʊˈboʊəm	re-ho-bo’-am
Rehoboth	riːˈhoʊbɒθ	re’-ho-both
Rehum	ˈriːhəm	re’-hum
Rei	riː	re’-i
Rekem	ˈriːkɛm	re’-kem
Remaliah	rɛmˈəliːə	rem-a-li’-ah
Remeth	ˈriːməθ	re’-meth
Remmon	ˈrɛmən	rem’-mon
Remmonmethoar	ˈrɛmənˌmɛθoʊˈɑːr	rem’-mon-meth’-o-ar
Remphan	ˈrɛmfæn	rem’-fan
Rephael	ˈriːfeɪəl	re’-fa-el
Rephah	ˈriːfə	re’-fah
Rephaiah	rɛfəˈiːə	ref-a-i’-ah
Rephaims	riːˈfeɪmz	re-fa’-ims
Rephidim	rɛfɪˈdɪm	ref’-i-dim
Resen	ˈriːzɛn	re’-zen
Resheph	ˈriːʃɛf	re’-shef
Reu	riːu	re’-u
Reuben	ˈruːbən	ru’-ben
Reubenites	ˈruːbənˌaɪts	ru’-ben-ites
Reuel	riːˈuːəl	re-u’-el
Reumah	riːˈuːmə	re-u’-mah
Rezeph	ˈriːzɛf	re’-zef
Rezia	riːˈziːə	re-zi’-ah
Rezin	ˈriːzɪn	re’-zin
Rezon	ˈriːzɒn	re’-zon
Rhegium	ˈriːdʒiəm	re’-je-um
Rhesa	ˈriːsə	re’-sah
Rhoda	ˈroʊdə	ro’-dah
Rhodes	roʊdz	rodes
Ribai	ˈrɪbaɪ	rib’-ahee
Riblah	ˈrɪblə	rib’-lah
Rimmon	ˈrɪmən	rim’-mon
Rimmonparez	ˈrɪmənˌpɛərɛz	rim’-mon-pa-’rez
Rinnah	ˈrɪnə	rin’-nah
Riphath	ˈraɪfætʰ	ri’-fath
Rissah	ˈrɪsə	ris’-sah
Rithmah	ˈrɪθmə	rith’-mah
Rizpah	ˈrɪzpə	riz’-pah
Roboam	roʊˈboʊəm	ro-bo’-am
Rogelim	roʊˈɡɛlɪm	ro’-ghel-im
Rohgah	roʊˈgə	ro’-gah
Romamtiezer	roʊˈmæmˌtiːˈɛzər	romam’-ti-e’-zur
Romans	ˈroʊmənz	ro’-muns
Rome	roʊm	rome
Rosh	roʊʃ	rosh
Rufus	ˈruːfəs	ru’-fus
Ruhamah	ruːˈhəmə	ru-ha’-mah
Rumah	ˈruːmə	ru’-mah
Ruth	ruːθ	rooth
Sabachthani	səˈbækθəni	sa-bak’-tha-ni
Sabaoth	ˈsæbəɑθ	sab’-a-oth
Sabeans	ˈsæbiːənz	sab-e’-uns
Sabta	ˈsæbtə	sab’-tah
Sabtah	ˈsæbtə	sab’-tah
Sabtecha	ˈsæbtɛkə	sab’-te-kah
Sabtechah	ˈsæbtɛkə	sab’-te-kah
Sacar	ˈsɛkər	sa’-kar
Sadducees	ˈsædəˌsiːz	sad’-du-sees
Sadoc	ˈsædək	sa’-dok
Sala	ˈsælə	sa’-lah
Salah	ˈsælə	sa’-lah
Salamis	ˈsæləmɪs	sal’-a-mis
Salathiel	səˈlæθiəl	sa-la’-the-el
Salcah	ˈsælkə	sal’-kah
Salchah	ˈsælkə	sal’-kah
Salem	ˈseɪləm	sa’-lem
Salim	ˈseɪlɪm	sa’-lim
Sallai	ˈsæləhiː	sal’-lahee
Sallu	ˈsælːu	sal’-lu
Salma	ˈsælmə	sal’-mah
Salmon	ˈsælmən	sal’-mon
Salmone	sælˈmoʊni	sal-mo’-ne
Salome	səˈloʊmi	sa-lo’-me
Salu	ˈsælːu	sa’-lu
Samaria	səˈmærɪə	sa-ma’-re-ah
Samaritans	səˈmærɪtənz	sa-mar’-i-tuns
Samgarnebo	ˈsæmgɑːrˈneɪboʊ	sam’-gar-ne’-bo
Samlah	ˈsæmlə	sam’-lah
Samos	ˈseɪmɒs	sa’-mos
Samothracia	sæmoʊˈθreɪʃə	sam-o-thra’-she-ah
Samson	ˈsæmsən	sam’-sun
Samuel	ˈsæmjuːəl	sam’-u-el
Sanballat	ˈsænˌbælət	san-bal’-lat
Sansannah	sænˈsænə	san-san’-nah
Saph	sæf	saf
Saphir	ˈsæfər	sa’-fur
Sapphira	safˈfiːrə	saf-fi’-rah
Sapphire	ˈsafˌaɪər	saf’-fire
Sara	ˈsɛərə	sa’-rah
Sarah	ˈsɛərə	sa’-rah
Sarai	səˈraɪ	sa’-rahee
Saraph	ˈsɛəræf	sa’-raf
Sardis	ˈsɑːrdɪs	sar’-dis
Sardites	ˈsɑːrdait्स	sar’-dites
Sardius	ˈsɑːrdiəs	sar’-di-us
Sardonyz	ˈsɑːrdoʊnɪks	sar’-do-nyx
Sarepta	səˈrɛptə	sa-rep’-tah
Sargon	ˈsɑːrɡən	sar’-gon
Sarid	ˈsɛərɪd	sa’-rid
Saron	ˈsɛərən	sa’-ron
Sarsechim	ˈsɑːrsəkɪm	sar’-se-kim
Saruch	ˈsɑːrʌk	sa’-ruk
Satan	ˈsɑːtən	sa’-tun
Satyr	ˈsɑːtər	sa’-tyr
Saul	ˈsɔːl	sawl
Sceva	ˈsiːvə	see’-vah
Scythian	ˈsɪθiən	sith’-e-un
Seba	ˈsebə	se’-bah
Sebat	ˈsebət	se’-bat
Secacah	siˈkakə	se-ca’-cah
Sechu	ˈseku	se’-ku
Secundus	siˈkʌndəs	se-cun’-dus
Segub	ˈseɡʌb	se’-gub
Seir	ˈseɪr	se’-ur
Seirath	ˈseɪrɑθ	se’-ur-ath
Sela	ˈselə	se’-lah
Selah	ˈselə	se’-lah
Selahammahlekoth	seˈlahhamˈmahleˈkoθ	se’-lah-ham-mah’-le-koth
Seled	ˈseˈled	se’-led
Seleucia	sɛlˈuʃiə	sel-u-si’-ah
Sem	ˈsem	sem
Semachiah	seməˈkiə	sem-a-ki’-ah
Semei	ˈseˈmi	sem’-e-i
Senaah	ˈseˈna	sen’-a-ah
Seneh	ˈseˈne	se’-neh
Senir	ˈseˈnɪr	se’-nur
Sennacherib	senəˈkerəb	sen-nak’-er-ib
Senuah	ˈseˈnuə	sen’-u-ah
Seorim	siˈɔrim	se-o’-rim
Sephar	ˈsefə	se’-far
Sepharad	ˈsefərəd	sef’-a-rad
Sepharvaim	ˈsefərˈvaɪm	sef-ar-va’-im
Sepharvites	ˈsefərˈvites	sef’-ar-vites
Serah	ˈserə	se’-rah
Seraiah	seˈraɪə	se-ra-i’-ah
Seraphims	ˈserəˈfɪmz	ser’-a-fims
Sered	ˈserəd	se’-red
Sergius	ˈsɜrdʒɪəs	sur’-je-us
Serug	ˈserəɡ	se’-rug
Seth	ˈseth	seth
Sethur	ˈseθər	se’-thur
Shaalabbin	ʃɑːˈlɑbəbɪn	sha-al-ab’-bin
Shaalbim	ʃɑːˈlɑbɪm	sha-al’-bim
Shaalbonite	ʃɑːˈlɑbəˈnaɪt	sha-al’-bo-nite
Shaaph	ʃəˈaf	sha’-af
Shaaraim	ʃɑːˈraɪm	sha-a-ra’-im
Shaashgaz	ʃɑːʃˈɡɑz	sha-ash’-gaz
Shabbethai	ʃæbˈbeɪθaɪ	shab’-be-thahee
Shachia	ʃəˈkiə	sha-ki’-ah
Shadrach	ʃəˈdræk	sha’-drak
Shage	ʃəˈɡe	sha’-ghe
Shaharaim	ʃɑːˈhaˈraɪm	sha-ha-ra’-im
Shahazimah	ʃɑːˈhazɪmə	sha-haz’-i-mah
Shalem	ʃəˈlem	sha’-lem
Salim	ʃəˈlim	sha’-lim
Shalisha	ʃəˈlisə	shal’-i-shah
Shallecheth	ʃəˈlekəθ	shal’-le-keth
Shallum	ʃəˈlum	shal’-lum
Shallun	ʃəˈlun	shal’-lun
Shalmai	ʃəˈlaɪ	shal’-mahee
Shalman	ʃəˈlɑːn	shal’-man
Shalmaneser	ʃælˈmɑːnəˈzer	shal-man-e’-zer
Shama	ʃəˈma	sha’-mah
Shamariah	ʃəməˈriə	sham-a-ri’-ah
Shamed	ʃəˈmed	sha’-med
Shamer	ʃəˈmər	sha’-mur
Shamgar	ʃæmˈɡɑr	sham’-gar
Shamhuth	ʃæmˈhuθ	sham’-huth
Shamir	ʃəˈmɪr	sha’-mur
Shamma	ʃæmˈmɑ	sham’-mah
Shammah	ʃæmˈmɑ	sham’-mah
Shammai	ʃæmˈmaɪ	sham’-mahee
Shammoth	ʃæmˈmoθ	sham’-moth
Shammua	ʃæmˈmuə	sham-mu’-ah
Shammuah	ʃæmˈmuə	sham-mu’-ah
Shamsherai	ʃæmˈʃeˈraɪ	sham’-she-rahee
Shapham	ʃæˈfæm	sha’-fam
Shaphan	ʃæˈfæn	sha’-fan
Shaphat	ʃæˈfæt	sha’-fat
Shapher	ʃæˈfʊr	sha’-fur
Sharai	ʃæˈraɪ	sha’-rahee
Sharaim	ʃæˈraɪm	sha-ra’-im
Sharar	ʃæˈrɑr	sha’-rar
Sharezer	ʃæˈreˈzʊr	sha-re’-zur
Sharon	ʃæˈrʊn	sha’-run
Sharonite	ʃæˈrʊnˈaɪt	sha’-run-ite
Sharuhen	ʃæˈruˈhɛn	sha-ru’-hen
Shashai	ʃæˈʃaɪ	sha’-shahee
Shashak	ʃæˈʃɑk	sha’-shak
Saul	ʃɔːl	sha’-ul
Saulites	ʃɔːlˈaɪts	sha’-ul-ites
Shaveh	ʃæˈve	sha’-veh
Shaveh Kiriathaim	ʃæˈveɪkɪˈriˈaɪm	sha’-veh-kir-e-a-thay’-im
Shavsha	ʃævˈʃɑ	shav’-shah
Sheal	ʃiˈɑl	she’-al
Shealtiel	ʃiˈalˈtiːl	she-al’-te-el
Sheariah	ʃiˈaˈriˈɑ	she-a-ri’-ah
Shearjashub	ʃiˈarˈʤəˈʃʊb	she’-ar-ja’-shub
Sheba	ʃiˈbæ	she’-bah
Shebah	ʃiˈbæ	she’-bah
Shebam	ʃiˈbæm	she’-bam
Shebaniah	ʃebˈaˈniˈɑ	sheb-a-ni’-ah
Shebarim	ʃebˈaˈrim	sheb’-a-rim
Sheber	ʃiˈbʊr	she’-bur
Shebna	ʃebˈnə	sheb’-nah
Shebuel	ʃiˈbuˈɛl	she-bu’-el
Shecaniah	ʃekˈaˈniˈɑ	shek-a-ni’-ah
Shechaniah	ʃekˈaˈniˈɑ	shek-a-ni’-ah
Shechem	ʃiˈkɛm	she’ kem
Shechemites	ʃiˈkɛmˈaɪts	she’-kem-ites
Shedeur	ʃedˈɛʊr	shed’-e-ur
Shehariah	ʃiˈhaˈriˈɑ	she-ha-ri’-ah
Shelah	ʃiˈlæ	she’-lah
Shelanites	ʃiˈlæˈnaɪts	she’-lan-ites
Shelemiah	ʃelˈeˈmiˈɑ	shel-e-mi’-ah
Sheleph	ʃiˈlef	she’-lef
Shelesh	ʃiˈles	she’-lesh
Shelomi	ʃelˈoˈmi	shel’-o-mi
Shelomith	ʃelˈoˈmɪθ	shel’-o-mith
Shelomoth	ʃelˈoˈmoth	shel’-o-moth
Shelumiel	ʃelˈuˈmiˈel	she-lu’-me-el
Shem	ʃɛm	shem
Shema	ʃiˈmɑ	she’-mah
Shemaah	ʃɛmˈaˈɑ	shem’-a-ah
Shemaiah	ʃɛmˈaˈiˈɑ	shem-a-i’-ah
Shemariah	ʃɛmˈaˈriˈɑ	shem-a-ri’-ah
Shemeber	ʃɛmˈeˈbur	shem-e’-bur
Shemer	ʃiˈmʊr	she’-mur
Shemida	ʃɛmˈiˈdɑ	shem-i’-dah
Shemidah	ʃɛmˈiˈdɑ	shem-i’-dah
Shemidaites	ʃɛmˈiˈdaɪts	shem’-i-dah-ites
Sheminith	ʃɛmˈɪnɪθ	shem’-i-nith
Shemiramoth	ʃɛmɪˈræmɑθ	she-mir’-a-moth
Shemuel	ʃɛmˈuˈɛl	shem-u’-el
Shen	ʃɛn	shen
Shenazar	ʃɛˈnɑːzər	she-na’-zar
Shenir	ʃɛˈnɪr	she’-nur
Shepham	ʃɛˈfæm	she’-fam
Shephathiah	ʃɛfəˈtiːə	shef-a-ti’-ah
Shephatiah	ʃɛfəˈtiːə	shef-a-ti’-ah
Shephi	ʃɛˈfi	she’-fi
Shepho	ʃɛˈfo	she’-fo
Shephuphan	ʃɛfˈuːfæn	shef’-u-fan
Sherah	ʃɛˈrɑ	she’-rah
Sherebiah	ʃɛrˈeˈbiːə	sher-e-bi’-ah
Sheresh	ʃɛˈreʃ	she’-resh
Sherezer	ʃɛˈreˈzʊr	she-re’-zur
Sheshach	ʃɛˈʃæk	she’-shak
Sheshai	ʃɛˈʃaɪ	she’-shahee
Sheshan	ʃɛˈʃæn	she’-shan
Sheshbazzar	ʃɛʃˈbæzər	shesh-baz’-zur
Sheth	ʃɛθ	sheth
Shethar	ʃɛˈθɑr	she’-thar
Shetharboznai	ʃɛˈθɑːrboznəɪ	she’-thar-boz’-nahee
Sheva	ʃɛˈvɑ	she’-vah
Shibboleth	ʃɪbˈbɒlɛθ	shib’-bo-leth
Shibmah	ʃɪbˈmɑ	shib’-mah
Shicron	ʃɪˈkrɒn	shi’-cron
Shiggaion	ʃɪgˈgeɪən	shig-gah’-yon
Shigionoth	ʃɪgˈiːənɒθ	shig-i’-o-noth
Shihon	ʃɪˈhɒn	shi’-hon
Shihor	ʃɪˈhɔːr	shi’-hor
Shihorlibnath	ʃɪˈhɔːrˈlɪbnəθ	shi’-hor-lib’-nath
Shilhi	ʃɪlˈhi	shil’-hi
Shilhim	ʃɪlˈhɪm	shil’-him
Shillem	ʃɪlˈlɛm	shil’-lem
Shillemites	ʃɪlˈlɛmˈaɪts	shil’-lem-ites
Shiloah	ʃiˈloʊə	shi-lo’-ah
Shiloh	ʃɪˈloʊ	shi’-loh
Shiloni	ʃiˈloʊni	shi-lo’-ni
Shilonites	ʃɪˈloʊnˈaɪts	shi’-lon-ites
Shilshah	ʃɪlˈʃɑ	shil’-shah
Shimea	ʃɪˈmiːə	shim’-e-ah
Shimeah	ʃɪˈmiːə	shim’-e-ah
Shimeam	ʃɪˈmiːəm	shim’-e-am
Shimeath	ʃɪˈmiːəθ	shim’-e-ath
Shimeathites	ʃɪˈmiːəθˈaɪts	shim’-e-ath-ites
Shimei	ʃɪˈmiː	shim’-e-i
Simeon	ʃɪˈmiːən	shim’-e-on
Shimhi	ʃɪmˈhi	shim’-hi
Shimi	ʃɪˈmi	shi’-mi
Shimites	ʃɪˈmaɪts	Shimites she’-mites)
Shimma	ʃɪmˈmə	shim’-mah
Shimon	ʃɪˈmɒn	shi’-mon
Shimrath	ʃɪmˈræθ	shim’-rath
Shimri	ʃɪmˈri	shim’-ri
Shimrith	ʃɪmˈrɪθ	shim’-rith
Shimrom	ʃɪmˈrom	shim’-rom
Shimron	ʃɪmˈron	shim’-ron
Shimronites	ʃɪmˈron-aɪts	shim’-ron-ites
Shimronmeron	ʃɪmˈron-me'-ron	shim’-ron-me’-ron
Shimshai	ʃɪmˈʃaɪ	shim’-shahee
Shinab	ʃiˈnab	shi’-nab
Shinar	ʃiˈnar	shi’-nar
Shiphi	ʃiˈfi	shi’-fi
Shiphmite	ʃɪfˈmaɪt	shif’-mite
Shiphrah	ʃɪfˈrɑ	shif’-rah
Shiphtan	ʃɪfˈtan	shif’-tan
Shisha	ʃiˈʃɑ	shi’-shah
Shishak	ʃiˈʃak	shi’-shak
Shitrai	ʃitˈraɪ	shit’-ra-i
Shittim	ʃitˈtɪm	shit’-tim
Shiza	ʃiˈzɑ	shi’-zah
Shoa	ʃoˈah	sho’-ah
Shobab	ʃoˈbab	sho’-bab
Shobach	ʃoˈbak	sho’-bak
Shobai	ʃoˈbaɪ	sho’-bahee
Shobal	ʃoˈbal	sho’-bal
Shobek	ʃoˈbek	sho’-bek
Shobi	ʃoˈbi	sho’-bi
Shocho	ʃoˈko	sho’-ko
Shochoh	ʃoˈko	sho’-ko
Shoco	ʃoˈko	sho’-ko
Shoham	ʃoˈham	sho’-ham
Shomer	ʃoˈmər	sho’-mur
Shophach	ʃoˈfak	sho’-fak
Shophan	ʃoˈfan	sho’-fan
Shoshannim	ʃo-ʃanˈnim	sho-shan’-nim
Shoshannim-Eduth	ʃoˈshanˈnim e'-duth	sho’-shan’-nim e’-duth
Shua	ʃuˈah	shu’-ah
Shuah	ʃuˈah	shu’-ah
Shual	ʃuˈal	shu’-al
Shubael	ʃuˈba-el	shu’-ba-el
Shuham	ʃuˈham	shu’-ham
Shuhamites	ʃuˈham-aɪts	shu’-ham-ites
Shuhite	ʃuˈhaɪt	shu’-hite
Shulamite	ʃuˈlam-aɪt	shu’-lam-ite
Shumathites	ʃuˈmath-aɪts	shu’-math-ites
Shunammite	ʃuˈnam-aɪt	shu’-nam-mite
Shunem	ʃuˈnem	shu’-nem
Shuni	ʃuˈni	shu’-ni
Shunites	ʃuˈnɪts	shu’-nites
Shupham	ʃuˈfam	shu’-fam
Shuphamites	ʃuˈfam-aɪts	shu’-fam-ites
Shuppim	ʃupˈpim	shup’-pim
Shur	ʃur	shur
Shushan	ʃuˈʃan	shu’-shan
Shushan-eduth	ʃuˈʃan-e'-duth	shu’-shan-e’-duth
Shuthalhites	ʃuˈthal-haɪts	shu’-thal-hites
Shuthelah	ʃuˈthe-lah	shu’-the-lah
Sia	siˈah	si’-ah
Siaha	siˈa-hah	si’-a-hah
Sibbecai	sibˈbe-kaɪ	sib’-be-cahee
Sibbecchai	sibˈbe-kaɪ	sib’-be-kahee
Sibboleth	sibˈbo-leth	sib’-bo-leth
Sibmah	sibˈmah	sib’-mah
Sibraim	sibˈra-im	sib’-ra-im
Sichem	siˈkem	si’-kem
Siddim	sidˈdim	sid’-dim
Sidon	siˈdon	si’-don
Sidonians	si-doˈne-uns	si-do’-ne-uns
Sihon	siˈhon	si’-hon
Sihor	siˈhor	si’-hor
Silas	siˈlas	si’-las
Silla	silˈlah	sil’-lah
Siloah	sɪˈloʊə	si-lo’-ah
Siloam	sɪˈloʊəm	si-lo’-am
Silvanus	sɪlˈveɪnəs	sil-va’-nus
Simeon	sɪˈmiən	sim’-e-un
Simeonites	sɪˈmiənˌaɪts	sim’-e-un-ites
Simon	ˈsaɪmən	si’-mun
Simri	ˈsɪmri	sim’-ri
Sin	sɪn	sin
Sina	ˈsiːnə	si’-nah
Sinai	sɪˈnaɪ	si’-nahee
Sinim	ˈsiːnɪm	si’-nim
Sinite	ˈsiːnaɪt	si’-nite
Sion	ˈsaɪən	si’-on
Siphmoth	ˈsɪfmɒθ	sif’-moth
Sippai	ˈsɪpʰeɪ	sip’-pahee
Sirah	ˈsiːrə	si’-rah
Sirion	sɪˈrɪən	sir’-e-on
Sisamai	sɪsˈəmeɪ	sis’-a-mahee
Sisera	sɪˈsɛrə	sis’-e-rah
Sitnah	ˈsɪtnə	sit’-nah
Sivan	ˈsiːvən	si’-van
Smyrna	ˈsmɜrnə	smir’-na
So	soʊ	so
Socho	ˈsoʊkoʊ	so’-ko
Sochoh	ˈsoʊkoʊ	so’-ko
Socoh	ˈsoʊkoʊ	so’-ko
Sodi	ˈsoʊdaɪ	so’-di
Sodom	ˈsɑdəm	sod’-om
Sodoma	sɒˈdoʊmə	sod’-o-mah
Sodomites	ˈsɑdəmaɪts	sod’-om-ites
Solomon	ˈsɑləmən	sol’-o-mun
Sopater	ˈsoʊpətər	so’-pa-tur
Sophereth	ˈsoʊfərəθ	so-fe’-reth
Sorek	ˈsoʊrɛk	so’-rek
Sosipater	ˈsoʊsɪpətər	so-sip’-a-tur
Sosthenes	ˈsɑsθəniz	sos’-the-neze
Sotai	ˈsoʊtaɪ	so’-tahee
Spain	speɪn	spane
Stachys	ˈsteɪkɪs	sta’-kis
Stacte	ˈstæktɪ	stac’-te
Stephanas	ˈstɛfənəs	stef’-a-nas
Stephen	ˈstiːvən	ste’-ven
Stoics	ˈstoʊɪks	sto’-ics
Suah	ˈsuːə	su’-ah
Succoth	ˈsʌkəθ	suc’-coth
Succothbenoth	ˈsʌkəθˌbiːnɒθ	suc’-coth-be’-noth
Suchathites	ˈsuːkəthaɪts	soo’-kath-ites
Sukkiims	ˈsʌkɪmz	suk’-ke-ims
Sur	sər	sur
Susanchites	suːˈzænkaɪts	su’-san-kites
Susanna	suːˈzænə	su-zan’-nah
Susi	ˈsuːsi	su’-si
Sychar	ˈsaɪkər	si’-kar
Sychem	ˈsaɪkɛm	si’-kem
Syene	sɪˈiːni	si-e’-ne
Syntyche	sɪnˈtɪki	sin’-ti-ke
Syracuse	ˈsɪrəkjuːs	sir’-a-cuse
Syria	ˈsɪərɪə	sir’-e-ah
Syriack	ˈsɪr.i.æk	sir’-e-ak
Syriadamascus	ˈsɪr.i.ə.dəˈmæs.kəs	sir’-e-ah-ma’-a-kah
Syriamaachah	ˈsɪr.i.əˈdæm.əskəs	sir’-e-ah-da-mas’-cus
Syrians	ˈsɪr.i.ənz	sir’-e-uns
Syrophenician	ˌsaɪ.roʊ.fɪˈni.ʃən	sy’-ro-fe-ne’-she-un
Taanach	ˈtɑː.ə.næk	ta’-a-nak
Taanathshiloh	ˈtɑː.ə.næθˈʃaɪ.loʊ	ta’-a-nath-shi’-lo
Tabbaoth	ˈtæb.beɪ.ɔθ	tab’-ba-oth
Tabbath	ˈtæb.bæθ	tab’-bath
Tabeal	ˈtæb.i.æl	tab’-e-al
Tabeel	ˈtæb.i.ɛl	tab’-e-el
Taberah	ˈtæb.i.rə	tab’-e-rah
Tabitha	ˈtæb.ɪ.θə	tab’-ith-ah
Tabor	ˈteɪ.bɔr	ta’-bor
Tabrimon	ˈtæb.rɪ.mɒn	tab’-rim-on
Tachmonite	ˈtæk.məˌnaɪt	tak’-mun-ite
Tadmor	ˈtæd.mɔr	tad’-mor
Tahan	ˈtɑː.hæn	ta’-han
Tahanites	ˈtɑː.hæn.aɪts	ta’-han-ites
Tahapanes	təˈhæp.əˌniz	ta-hap’-a-neze
Tahath	ˈtɑː.hæθ	ta’-hath
Tahpanhes	ˈtɑːpˌpæn.hiz	tah’-pan-heze
Tahpenes	ˈtɑːpˌpi.niz	tah’-pe-neze
Tahrea	ˈtɑː.rɪə	tah’-re-ah
Tahtimhodshi	ˈtɑː.tɪmˈhɒd.ʃi	tah’-tim-hod’-shi
Talitha	ˈtæl.ɪ.θə	tal’-ith-ah
Talmai	ˈtæl.maɪ	tal’-mahee
Talmon	ˈtæl.mɒn	tal’-mon
Tamah	ˈtɑː.mə	ta’-mah
Tamar	ˈtɑː.mɑr	ta’-mar
Tammuz	ˈtæm.muz	tam’-mu
Tanach	ˈtɑː.næk	ta’-nak
Tanhumeth	ˈtæn.hjʊ.mɛθ	tan’-hu-meth
Taphath	ˈtɑː.fæθ	ta’-fath
Tappuah	ˈtæp.pwɑː	tap’-pu-ah
Tarah	ˈtɑː.rə	ta’-rah
Taralah	ˈtær.ə.lə	tar’-a-lah
Tarea	ˈtɑː.rɪə	ta’-re-ah
Tarpelites	ˈtɑr.pɛl.aɪts	tar’-pel-ites
Tarshish	ˈtɑr.ʃɪʃ	tar’-shish
Tarsus	ˈtɑr.səs	tar’-sus
Tartak	ˈtɑr.tæk	tar’-tak
Tartan	ˈtɑr.tæn	tar’-tan
Tatnai	ˈtæt.naɪ	tat’-nahee
Tebah	ˈtɛ.bə	te’-bah
Tebaliah	ˌtɛb.əˈlaɪ.ə	teb-a-li’-ah
Tebeth	ˈtɛ.bɛθ	te’-beth
Tehaphnehes	tɛˈhæf.niˌhiz	te-haf’-ne-heze
Tehinnah	tɛˈhɪn.ə	te-hin’-nah
Tekel	ˈtɛ.kɛl	te’-kel
Tekoa	tɛˈkoʊ.ə	te-ko’-ah
Tekoah	tɛˈkoʊ.ə	te-ko’-ah
Tekoites	tɛˈkoʊ.aɪts	te-ko’-ites
Telabib	ˈtɛl.əˌbɪb	tel-a’-bib
Telah	ˈtɛ.lə	te’-lah
Telaim	ˈtɛl.aɪm	tel’-a-im
Telassar	ˈtɛl.əˌsɑr	te-las’-sar
Telem	ˈtɛ.lɛm	te’-lem
Telharesha	ˌtɛl.həˈrɛ.ʃə	tel-ha-re’-shah
Telharsa	ˈtɛl.hɑr.sə	tel-har’-sah
Telmelah	ˈtɛl.mɛ.lə	tel-me’-lah
Tema	ˈtɛ.mə	te’-mah
Teman	ˈtɛ.mæn	te’-man
Temani	ˈtɛ.mə.ni	te’-ma-ni
Temanites	ˈtɛ.məˌnaɪts	te’-man-ites
Temeni	ˈtɛm.ɛ.ni	tem’-e-ni
Terah	ˈtɛ.rə	te’-rah
Teraphim	ˈtɛr.ə.fɪm	ter’-af-im
Teresh	təɹˈɛʃ	te’-resh
Tertius	tərˈʃiːəs	tur’-she-us
Tertullus	tərˈtʌlʌs	tur-tul’-lus
Thaddaeus	θəˈdiːəs	thad-de’-us
Thahash	θəˈhæʃ	tha’-hash
Thamah	θəˈmɑː	tha’-mah
Thamar	θəˈmɑːr	tha’-mar
Thara	θəˈɹɑː	tha’-rah
Tharshish	θɑːrˈʃɪʃ	thar’-shish
Thebez	θiːˈbɛz	the’-bez
Thelasar	θiːˈlɑːsɑːr	the-la’-sar
Theophilus	θiːˈɑːfɪləs	the-of’-il-us
Thessalonians	θɛs əˈloʊniənz	thes-sa-lo’-ne-uns
Thessalonica	θɛs əˈlɒnɪkə	thes-sa-lo-ni’-cah
Theudas	θiːˈwʌdæs	thew’-das
Thimnathah	θɪmˈnæθə	thim’-nath-ah
Thomas	ˈtɒməs	tom’-us
Thummim	ˈθʌmɪm	thum’-mim
Thyatira	θaɪ əˈtɪərə	thi-a-ti’-rah
Tiberias	təɪbɪˈɹiːəs	ti-be’-re-as
Tiberius	təɪˈbɪərɪəs	ti-be’-re-us
Tibhath	ˈtɪbhæθ	tib’-hath
Tibni	ˈtɪbnɪ	tib’-ni
Tidal	ˈtaɪdəl	ti’-dal
Tiglathpileser	ˈtɪglæθ paɪˈliːzər	tig’-lath-pi-le’-zur
Tikvah	ˈtɪkvɑː	tik’-vah
Tikvath	ˈtɪkvɑθ	tik’-vath
Tilgathpilneser	ˈtɪlˌgæθ paɪˈliːzər	til’-gath-pil-ne’-zur
Tilon	ˈtaɪlən	ti’-lon
Timaeus	təˈmaɪəs	ti-me’-us
Timna	ˈtɪmnə	tim’-nah
Timnah	ˈtɪmnə	tim’-nah
Timnath	ˈtɪmnæθ	tim’-nath
Timnathheres	ˈtɪmnæθ hɪəz	tim’-nath-he’-rez
Timnathserah	ˈtɪmnæθ sɪəɹə	tim’-nath-se’-rah
Timnite	ˈtɪmnaɪt	tim’-nite
Timon	ˈtaɪmən	ti’-mon
Timotheus	təˈmaɪðiːəs	tim-o’-the-us
Timothy	ˈtɪməθi	tim’-o-thy
Tiphsah	ˈtɪfsə	tif’-sah
Tiras	ˈtaɪræs	ti’-ras
Tirathites	təˈɹeɪθaɪts	ti’-rath-ites
Tirhakah	tərˈhɑːkə	tur-ha’-kah
Tirhanah	tərˈhɑːnə	tur-ha’-nah
Tiria	ˈtɪərɪə	tir’-e-ah
Tirshatha	tərˈʃɑːθə	tur’-sha-thah
Tirzah	ˈtɜːrzə	tur’-zah
Tishbite	ˈtɪʃbaɪt	tish’-bite
Titus	ˈtaɪtəs	ti’-tus
Tizite	təˈzaɪt	ti’-zite
Toah	ˈtoʊə	to’-ah
Tob	tɒb	tob
Tobadonijah	ˈtoʊb ə doʊ niːˈjə	tob’-ad-o-ni’-jah
Tobiah	toʊˈbaɪə	to-bi’-ah
Tobijah	toʊˈbaɪə	to-bi’-jah
Tochen	ˈtoʊkən	to’-ken
Togarmah	toʊˈgɑːrmə	to-gar’-mah
Tohu	ˈtoʊhu	to’-hu
Toi	toʊi	to’-i
Tola	ˈtoʊlə	to’-lah
Tolad	ˈtoʊlæd	to’-lad
Tolaites	təˈloʊaɪts	to’-lah-ites
Topaz	ˈtoʊpæz	to’-paz
Tophel	ˈtoʊfəl	to’-fel
Tophet	ˈtoʊfɛt	to’-fet
Topheth	ˈtoʊfɛt	to’-feth
Tou	toʊ	to’-u
Trachonitis	trəˈkoʊnɪtɪs	trak-o-ni’-tis
Troas	troʊəs	tro’-as
Trogyllium	troʊˈdʒɪliəm	tro-jil’-le-um
Trophimus	ˈtroʊfɪməs	trof’-im-us
Tryphena	triːˈfiːnə	tri-fe’-nah
Tryphosa	triːˈfoʊzə	tri-fo’-sah
Tubal	ˈtjuːbəl	tu’-bal
Tubalcain	ˈtjuːbəlkeɪn	tu’-bal-cain
Tychicus	ˈtɪkɪkəs	tik’-ik-us
Tyrannus	təˈrænəs	ti-ran’-nus
Tyre	taɪər	tire
Tyrus	ˈtaɪrəs	ti’-rus
Ucal	ˈjuːkæl	u’-cal
Uel	ˈjuːəl	u’-el
Ufarsin	ˈjuːfɑːrsɪn	u’-far-sin
Ulai	ˈʌləɪ	ul’-lah
Ulam	ˈʌləm	u’-lam
Ulla	ˈʌlə	ul’-lah
Ummah	ˈʌmə	um’-mah
Unni	ˈʌni	un’-ni
Upharsin	juːˈfɑːrsɪn	u-far’-sin
Uphaz	ˈjuːfæz	u’-faz
Ur	ər	ur
Urbane	ˈɜːrbeɪn	ur’-bane
Uri	ˈjʊəri	u’-ri
Uriah	juːˈraɪə	u-ri’-ah
Urias	juːˈraɪəs	u-ri’-as
Uriel	ˈjʊəriəl	u’-re-el
Urijah	juːˈraɪə	u-ri’-jah
Urim	ˈjʊərɪm	u’-rim
Uthai	juːˈðaɪhiː	u’thahee
Uz	ʌz	uz
Uzai	juːˈzaɪhiː	u’-zahee
Uzal	ˈʌzəl	u’-zal
Uzza	ˈʌzə	uz’-zah
Uzzah	ˈʌzə	uz’-zah
Uzzensherah	ˈʌzənʃɪɹə	uz’-zen-she’-rah
Uzzi	ˈʌzi	uz’-zi
Uzzia	ʌzˈziːə	uz-zi’-ah
Uzziah	ʌzˈziːə	uz-zi’-ah
Uzziel	ʌzˈziːəl	uz-zi’-el
Uzzielites	ʌzˈziːəl-aɪts	uz-zi’-el-ites
Vajezatha	vəˈdʒɛzəθə	va-jez’-a-thah
Vaniah	vəˈnaɪə	va-ni’-ah
Vashni	ˈvɑːʃni	vash’-ni
Vashti	ˈvɑːʃti	vash’-ti
Vophsi	ˈvoʊfsi	vof’-si
Zaanaim	zaːʔəˈnaɪm	za-an-a’-im
Zaanan	zaːʔəˈnæn	za’-an-an
Zaanannim	zaːʔəˈnænɪm	za-an-an’-nim
Zaavan	zaːʔəˈvæn	za’-av-an
Zabad	zaːˈbæd	za’-bad
Zabbai	zæbˈbaɪhiː	zab’-bahee
Zabbud	zæbˈbʌd	zab’-bud
Zabdi	zæbˈdi	zab’-di
Zabdiel	zæbˈdiːəl	zab’-de-el
Zabud	zaːˈbʌd	za’-bud
Zabulon	zæbˈjʊlən	zab’-u-lon
Zaccai	zækˈkaɪhiː	zac’-cahee
Zacchaeus	ˈzækɪəs	zak-ke’-us
Zacchur	ˈzækər	zac’-cur
Zaccur	ˈzækər	zac’-cur
Zachariah	ˌzæk ə ˈraɪə	zak-a-ri’-ah
Zacharias	ˌzæk ə ˈraɪəs	zak’-a-ri’-as
Zacher	ˈzaːkər	za’-kur
Zadok	ˈzaːdɒk	za’-dok
Zaham	ˈzaːhæm	za’-ham
Zair	ˈzaːər	za’-ur
Zalaph	ˈzaːlæf	za’-laf
Zalmon	ˈzælmən	zal’-mon
Zalmonah	ˌzæl məʊ̯ ˈnɑː	zal-mo’-nah
Zalmunna	ˌzæl məʊ̯ ˈnə	zal-mun’-nah
Zamzummims	ˌzæm ˈzʌmɪmz	zam-zum’-mims
Zanoah	zaːˈnoʊə	za-no’-ah
Zaphnathpaaneah	ˈzæf nəθ peɪ ə ˈniːə	zaf’-nath-pa-a-ne’-ah
Zaphon	ˈzaːfɒn	za’-fon
Zara	ˈzaːrə	za’-rah
Zara	ˈzaːrə	za’-rah
Zareah	zaːˈriːə	za’-re-ah
Zareathites	zaːˈriːəθaɪts	za’-re-ath-ites
Zared	ˈzaːrɛd	za’-red
Zarephath	ˈzɑːrɪfæθ	zar’-e-fath
Zaretan	ˈzɑːrɪtæn	zar’-e-tan
Zarethshahar	ˈzaːrɛθ ʃəˈhɑːr	za’-reth-sha’-har
Zarhites	ˈzɑːrhaɪts	zar’-hites
Zartanah	ˈzɑːrtənə	zar’-ta-nah
Zarthan	ˈzɑːrθən	zar’-than
Zatthu	ˈzæθuː	zath’-u
Zattu	ˈzættuː	zat’-tu
Zavan	ˈzaːvæn	za’-van
Zaza	ˈzaːzə	za’-zah
Zebadiah	ˌzɛb ə ˈdaɪə	zeb-ad-i’-ah
Zebah	ˈziːbə	ze’-bah
Zebaim	ˈziːbaɪm	ze-ba’-im
Zebedee	ˈzɛbɪdiː	zeb’-e-dee
Zebina	ˈzɛbɪnə	ze-bi’-nah
Zeboiim	ˌziːˈbɔɪɪm	ze-boy’-im
Zeboim	ˈziːbɔɪm	ze-bo’-im
Zebudah	zɛˈbuːdə	ze-bu’-dah
Zebul	ˈziːbəl	ze’-bul
Zebulonite	ˈzɛb jʊlən aɪt	zeb’-u-lon-ite
Zebulun	ˈzɛb jʊlən	zeb’-u-lun
Zebulunites	ˈzɛb jʊlən aɪts	zeb’-u-lun-ites
Zechirah	ˈzɛk ə ˈraɪə	zek-a-ri’-ah
Zedad	ˈziːdæd	ze’-dad
Zedekiah	ˌzɛd ə ˈkaɪə	zed-e-ki’-ah
Zeeb	ˈziːb	ze’-eb
Zelah	ˈziːlə	ze’-lah
Zelek	ˈziːlɛk	ze’-lek
Zelophehad	ˌziːˈloʊfɪhæd	ze’lo’-fe-had
Zelotes	ˌzɛˈloʊtiːz	ze-lo’-teze
Zelzah	ˈzɛlzə	zel’-zah
Zemaraim	ˌzɛm ə ˈraɪɪm	zem-a-ra’-im
Zemarite	ˈzɛm ə raɪt	zem’-a-rite
Zemira	zɛˈmiːrə	ze-mi’-rah
Zenan	ˈziːnæn	ze’-nan
Zenas	ˈziːnəs	ze’-nas
Zephaniah	ˌzɛf ə ˈnaɪə	zef-a-ni’-ah
Zephath	ˈziːfæθ	ze’-fath
Zephathah	ˈzɛf ə thɑː	zef’-a-thah
Zephi	ˈziːfaɪ	ze’-fi
Zepho	ˈziːfoʊ	ze’-fo
Zephon	ˈziːfɒn	ze’-fon
Zephonites	ˈzɛf ən aɪts	zef’-on-ites
Zer	zər	zur
Zerah	ˈziːrə	ze’-rah
Zerahiah	ˌzɛr ə ˈhaɪə	zer-a-hi’-ah
Zered	ˈziːrɛd	ze’-red
Zereda	ˈzɛrɪdə	zer’-e-dah
Zeredathah	zɛˈrɛd ə thɑː	ze-red’-a-thah
Zererath	ˈzɛrɪræθ	zer’-e-rath
Zeresh	ˈziːrɛʃ	ze’-resh
Zereth	ˈziːrɛθ	ze’-reth
Zeri	ˈziːraɪ	ze’-ri
Zeror	ˈziːrɔr	ze’-ror
Zeruah	zɛˈruːə	ze-ru’-ah
Zerubbabel	zɛˈrʌb ə bɛl	ze-rub’-ba-bel
Zeruiah	zɛˈruːiə	ze-ru-i’-ah
Zetham	ˈziːθəm	ze’-tham
Zethan	ˈziːθæn	ze’-than
Zethar	ˈziːθɑːr	ze’-thar
Zia	ˈziːə	zi’-ah
Ziba	ˈziːbə	zi’-bah
Zibeon	ˈzɪbɪʌn	zib’-e-un
Zibia	ˈzɪbɪə	zib’-e-ah
Zibiah	ˈzɪbɪə	zib’-e-ah
Zichri	ˈzɪkri	zik’-ri
Ziddim	ˈzɪdɪm	zid’-dim
Zidkijah	ˌzɪd kiːdʒə	zid-ki’-jah
Zidon	ˈziːdɒn	zi’-don
Zidonians	ziːˈdoʊniənz	zi-do’-ne-uns
Zif	zɪf	zif
Ziha	ˈziːhə	zi’-hah
Ziklag	ˈzɪklæg	zik’-lag
Zillah	ˈzɪlə	zil’-lah
Zilpah	ˈzɪlpæ	zil’-pah
Zilthai	ˈzɪlθaɪhiː	zil’-thahee
Zimmah	ˈzɪmə	zim’-mah
Zimran	ˈzɪmræn	zim’-ran
Zimri	ˈzɪmraɪ	zim’-ri
Zina	ˈziːnə	zi’-nah
Zion	ˈziːən	zi’-un
Zior	ˈziːɔr	zi’-or
Ziph	zɪf	zif
Ziphah	ˈziːfə	zi’-fah
Ziphims	ˈzɪfɪmz	zif’-ims
Ziphion	ˈzɪfɪən	zif’-e-on
Ziphites	ˈzɪfaɪts	zif’-ites
Ziphron	ˈzɪfrɒn	zif’-ron
Zippor	ˈzɪpɔr	zip’-por
Zipporah	ˈzɪp ə rɑː	zip-po’-rah
Zithri	ˈzɪθri	zith’-ri
Ziz	zɪz	ziz
Ziza	ˈziːzə	zi’-zah
Zizah	ˈziːzə	zi’-zah
Zoan	ˈzoʊæn	zo’-an
Zoar	ˈzoʊər	zo’-ar
Zoba	ˈzoʊbə	zo’-bah
Zobah	ˈzoʊbə	zo’-bah
Zobebah	zoʊˈbiːbə	zo-be’-bah
Zohar	ˈzoʊhɑːr	zo’-har
Zoheleth	ˈzoʊhɛlɛθ	zo’-he-leth
Zoheth	ˈzoʊhɛθ	zo’-heth
Zophah	ˈzoʊfə	zo’-fah
Zophai	zoʊˈfaɪhiː	zo’-fahee
Zophar	ˈzoʊfɑːr	zo’-far
Zophim	ˈzoʊfɪm	zo’-fim
Zorah	ˈzoʊrə	zo’-rah
Zorathites	zoʊˈræθaɪts	zo’-rath-ites
Zoreah	zoʊˈriːə	zo’-re-ah
Zorites	zoʊˈraɪts	zo’-rites
Zorobabel	zoʊˈrɔb ə bɛl	zo-rob’-a-bel
Zuar	ˈzuːɑːr	zu’-ar
Zuph	zʌf	zuf
Zur	zər	zur
Zuriel	ˈzuːriəl	zu’-re-el
Zurishaddai	zuː rɪ ˈʃæddaɪ	zu-re-shad’-da-i
Zuzims	ˈzuːzɪmz	zu’-zims